锂	元素
解放军报	报刊
柬埔寨	行政区划
耶律楚材	政治家
八卦山	行政区划
鎏金	工艺
格林纳达	行政区划
希腊	行政区划
俞济时	人物
徐麒雯	演员
鹿特丹	行政区划
丛台	行政区划
窦金庸	画家
姜大卫	演员
柳峰乡	行政区划
原子鏸	演员
彭佳屿	行政区划
曾宝仪	演员
陈松伶	演员
铁人三项	项目
印第安纳波利斯	城市
台州	城市
蔡一杰	演员
猪	肉类
呃逆	疾病
罗敏庄	演员
外感	疾病
电磁炮	武器
多哈	行政区划
湖南卫视	媒体
巴雷	行政区划
徐智英	演员
麦兆辉	导演
周一围	演员
谭小环	演员
柳健	演员
马文瑞	领导人
白冰冰	演员
罗荣桓	革命家
宋体	字体
解放日报	报刊
环县	县
钢琴	音乐
巴赫金	人物
秃疮	疾病
成宥利	演员
范曾	书法家
梆子腔	戏曲
铁矿	矿物
氟	气体
菊豆	电影
北京航空航天大学	大学
林采茂	演员
蕹菜	植物
反转片	术语
卫诗	歌手
公馆	建筑
音韵学	文献学
配偶	婚姻
国务院妇女儿童工作委员会	机构
牌九	游戏
范晓萱	女歌手
散尾葵	棕榈科
曼陀铃	音乐
银鸥	观赏鸟
道县	县
算死草	喜剧
营销师	职业
祁县	县
硬石膏	矿物
躁狂症	心理
宋智爱	偶像
大男子主义	行为
防御	战斗
许茹芸	歌手
谷德昭	编剧
千明勋	演员
麦凯	城市
肝硬化	常见疾病
郑进永	导演
特里尔	城市
金钟民	演员
帝国主义	资本主义
茯苓	中药
吊灯	生活用品
狂犬病毒	传染病
北运河	运河
王志功	技术
南京大学	东南大学
睫毛膏	化妆品
义勇军	抗日
乙醇	有机物
任薰	画家
边塞诗	唐诗
炸酱面	食品
纨扇	扇子
橡胶	胶水
投手	棒球
陈奂仁	歌手
景颇族	少数民族
绿色版	软件
斗笠	器具
黑日危机	电影
红霉素	药品
波罗乃兹	音乐
金山快译	应用软件
普兰店	县
菡子	作家
水苏糖	保健品
谢冰心	作家
徐柳仙	演员
收缩机	包装
精算师	职业
信远斋	食品
农梦特	化学品
校准	测量
戴粹伦	音乐家
苏门答腊虎	动物
福特	公司
孙墨龙	画家
何多苓	人物
甲地孕酮	药品
吴国敬	歌手
磷酸氯喹	抗疟药
头孢拉定	药品
六言诗	宋诗
钱红丽	作家
黑山县	县
公仔面	食品
咪喹莫特	药品
临海	城市
成公亮	演奏家
何键	国民党
明日帝国	动作片
黎锦明	作家
谋女郎	演员
藕节	中药
大连理工大学	华中科技大学
卡巴列夫斯基	作曲家
上海浦东发展银行	金融机构
会理县	凉山州
中国金币总公司	企业
卡萨欣	音乐
心肌缺血	心脏病
老狼	歌手
吴家丽	香港艺人
刘祚昌	教育家
瓯越	民族
悲观主义	主义
阎纯德	作家
李慕良	京剧
培氟沙星	抗生素
沈阳站	京哈线
锡永	城市
周子寒	演员
碘甘油	药品
君主立宪制	制度
火力发电	发电
反町隆史	演员
哲学博士	学位
北京外国语大学	大学
国画家	艺术家
赖少其	画家
滚刀	刀具
砖茶	茶
夏圭	画家
孔西	区划
欧洲社会党	政党
呼吸肌	呼吸系统
高等教育出版社	出版社
陈小汉	演员
通脉	疾病
防汛	工作
布尔诺	城市
头孢哌酮钠	抗生素
位伯镇	行政区划
排比	写作
连江县	县
莫艳琳	歌手
张系国	作家
徐静蕾	才女
钢化玻璃	建筑材料
师胜杰	曲艺
芽孢	细菌
胶体	涂料
常委	委员
分节歌	音乐
水文测验	水文
潘海天	科幻
刘彻	汉武帝
日本大学	大学
金银花	花茶
陆越子	艺术家
朊病毒	疾病
洪治纲	人物
徐树铮	北洋军阀
旅行支票	外汇
氰化钠	危险品
广州东站	车站
网络适配器	网络通讯
铜版	制版
克隆	遗传学
艾启蒙	画家
夏坚勇	作家
马长礼	京剧
平型关	关隘
云爆弹	炸弹
勾股定理	几何
葡萄牙文	国家
长袍马褂	服装
国画家	美术家
温带气候	气候
茅盾	著名作家
内蒙古人民出版社	出版社
薄荷	野菜
罗曼菲	舞蹈家
徐绍史	领导人
郎绍君	人物
马志存	演员
劈离砖	瓷砖
华尔街日报	报纸
王传一	歌手
成宥利	美女
黑松	松科
偏关县	县
邝美云	歌手
陶建幸	企业
丁国红	教师
东坡肉	食品
蕤仁	中药材
鱼藤	豆科
机箱	设备
潘天寿	艺术家
董希源	画家
卡塞拉	作曲家
小蜂	膜翅目
版画	工艺美术
垄断组织	资本主义
短号	音乐
脂砚斋	曹雪芹
扑热息痛	镇痛药
巴芬岛	岛屿
吴骏圣	艺术家
区瑞强	歌手
泼尼松	药品
韩天衡	书法家
气喘病	常见疾病
席慕蓉	作家
杨镰	作家
董柯娣	越剧
专科	研究生
睢宁	城市
星族	银河系
塞班岛	太平洋
肚兜	内衣
乔治敦大学	大学
蓝细菌	生物
阿弟仔	演员
焊	制造
第一张	音乐
堪察加半岛	半岛
东川区	云南省
桂文亚	人物
清远	城市
棕壤	土壤
唐招提寺	寺院
溥心畲	画家
刘俊纬	演员
古桥	建筑
申凤梅	演员
汪精卫	汉奸
充分就业	市场经济
淋巴细胞	结缔组织
八大菜系	传统
控制器	仪器
氢氧化铯	化学品
诸葛恢	宰相
军鼓	音乐
皮损	皮肤病
王馨平	港台明星
尤卓尔	药品
东方时空	媒体
陈好	美女
邓发	党史
蔡元培	教育家
康成元	艺术家
李存勖	后唐
四白	疾病
芦笋	特产
翠文	花卉
昌珠寺	寺院
小青湖	景区
李建仁	演员
田樾	作家
安坦	药品
上官鼎	武侠小说
壁灯	家具
氯化锌	无机盐
免税	税务
孔庆东	百家讲坛
磁座钻	电动工具
火炬树	植物
惠而浦	制造业
雷响茶	茶
虎耳草	植物药
利福定	抗生素
毒重石	矿物
小旦	戏剧
虎纹蛙	两栖动物
崖柏	植物
七言律诗	近体诗
白消安	化学品
宝塔	建筑物
潘仪君	港台明星
马铃薯	植物
路德宗	教会
红安县	城市
美国联邦调查局	情报机构
吉娃娃	狗
孙泰英	美女
莫斯科大学	大学
科斯蒂尼亚	足球明星
乙酰唑胺	药品
氪	气体
舒国滢	法理学
紫丁香	花卉
替身演员	角色
圣纪节	节日
蒋怡	模特
铁苋菜	植物药
大叶黄杨	花卉
胎毛笔	办公用品
shtml	文档
茶缸	日用品
算法	代数
蔡安安	演员
金汝真	演员
古崖居	遗址
北京市第八中学	学校
福州话	闽语
波斯菊	花卉
江苏省国画院	画院
透闪石	宝石
录音	技术
井陉县	行政区域
潘耀明	作家
蒋子丹	作家
张寿彭	人物
糯米纸	造纸
氯化铵	无机盐
侦察机	武器
大江健三郎	人物
尘埃云	宇宙
天体	宇宙
噪声污染	环境
陈质枫	领导
间歇泉	温泉
白良关	京剧
纳粹德国	希特勒
莫文蔚	歌手
额济纳旗	阿拉善盟
宗正	官职
詹化雨	军队
木冬树	木犀科
苏州大学	大学
宣肺	疾病
大报	词语
太华寺	寺庙
橡树	树种
吕纪	绘画
郑信	皇帝
巴布亚新几内亚	岛国
杭子梢	花卉
金曼龙	观赏鱼
铁线蕨	植物药
郭全宝	表演艺术
发簪	饰品
艾捷克	音乐
宝坻区	宝坻
定音鼓	西洋乐器
外汇储备	汇率
普格县	凉山州
导演	明星
资生堂	奢侈品
鸭嘴兽	动物
拿来主义	思想
氰化氢	危险品
虎刺	植物
花岗石	石材
棕榈	棕榈科
程安东	省长
梨花大鼓	曲艺
中微子	宇宙学
环翠区	行政
晓之车	音乐
陈立品	电影人
套汇	期货
关礼杰	港台明星
塞内加尔	莱索托
甲芬那酸	镇痛药
穆旦	人物
韩高恩	明星
玉堂镇	都江堰
明十三陵	帝陵
龙康华	人物
王一亭	艺术家
招生简章	招生
易竹贤	作家
地质录井	技术
托福	英语
韩月乔	电影人
书法	书法家
国际唱片业协会	知识产权
阜康	城市
板蓝根	野菜
城管局	机构
锣	西洋乐器
孙建江	作家
罗斯托夫	城市
乌拉坦	药品
弗德里克	城市
白苏	药材
裙裤	服饰
电子称	电子秤
渭源县	县
王金璐	武生
单果	果实
晏紫	体育明星
文县	陇南
铅笔盒	文具
天宁区	行政区域
贾晓晨	歌手
大秦铁路	运输
异装癖	精神疾病
园林景观	环境
吕舒怀	作家
名歌手	歌剧
熊任望	艺术家
珍珠奶茶	茶
奎尼丁	药品
施存统	共产党
安利	直销
终兴镇	单县
松峰山	名山
吴胜恩	美女
中国少年先锋队	组织
真空管	三极管
公共交通	交通运输
恩诺沙星	杀菌
足少阴肾经	经脉
速射炮	武器
香里奈	演员
日全食	日食
基里巴斯	大洋洲
朱棣	明朝
地王大厦	摩天大楼
田振崴	明星
红门兰	植物
尹馨	歌手
龙合寺	寺庙
文心兰	花卉
安在模	明星
马中才	人物
张悦然	作家
徐信爱	明星
硝酸银	药品
陈彪如	经济学家
自动识别	条码
张白山	翻译家
印刷电路	半导体
合川县	行政
乌拉圭东岸共和国	不结盟运动
神经病学	学科
蓝茉莉	花卉
利尿药	药品
钱世明	作家
高老头	小说
过氧化钙	无机物
千头柏	柏科
氟骨病	中毒
何非凡	表演艺术
三垛镇	区划
乔戈里	山脉
烧饼油条	小吃
洛赛克	处方药
扎鲁特旗	地区
业务员	业务
石斑木	药用植物
乐凯胶片	股份公司
李苦禅	国画家
朱乃正	艺术工作者
焦烧	工艺
水禾属	禾本科
韩国菜	菜肴
哈尔滨铁路局	铁路局
燕郊	廊坊
迟营乡	行政区划
黄珊汕	体操
大枣	枣类
阎欣宁	作家
