侯虞钧	人物
张国宾	人物
橘庆太	人物
夏侠	人物
水木亚丁	人物
昂头阔步	词语
鹰心雁爪	词语
贺麟	人物
宣化承流	词语
杨忠道	人物
钟马田	人物
晓卉	人物
跛行千里	词语
秦毓鎏	人物
殷震	人物
吴维库	人物
附赘悬肬	词语
陈豫钟	人物
烈火辨日	词语
刘炫	人物
杨贵贞	人物
周嘉谟	人物
丁济万	人物
郑虎臣	人物
神领意造	词语
顾震潮	人物
陈忠经	人物
平卡斯	人物
孙倬	人物
趑趄	词语
支仲元	人物
工藤静香	人物
王神爱	人物
怡悦	词语
姚剑云	人物
从善如流	词语
蔡福	人物
潘达微	人物
陈璜	人物
金天柱	人物
不失黍絫	词语
当立之年	词语
陆汝钤	人物
宗馥莉	人物
孔公恂	人物
施蒂纳	人物
周光召	人物
陈翠贞	人物
房开江	人物
阎朝隐	人物
伏格乐	人物
怡声下气	词语
见外	词语
曝骨履肠	词语
唐培	人物
曾鼎乾	人物
杨玉环	人物
徐建铭	人物
陈士橹	人物
曙后星孤	词语
长颈鸟喙	词语
张启龙	人物
聂树人	人物
李汉俊	人物
马替奴	人物
廉远堂高	词语
李露	人物
慰唁	词语
陈荫林	人物
涕泗横流	词语
梁培基	人物
李鹗	人物
为难	词语
谢克西	人物
推燥居湿	词语
蔺道人	人物
消释	词语
闾阎安堵	词语
戒惧	词语
黄葆同	人物
张泊泉	人物
王肯堂	人物
汤火圣	人物
杨衡	人物
张太雷	人物
沈炳震	人物
温吞	词语
声动梁尘	词语
束手坐视	词语
秦含章	人物
空文	词语
聊以自娱	词语
逼肖	词语
愚昧无知	词语
史康	人物
生发未燥	词语
郑文中	人物
历历	词语
令亲	词语
周崇华	人物
谷善庆	人物
张彩珍	人物
厉恩海	人物
欣然自得	词语
刘自鸣	人物
平尧卿	人物
李明灏	人物
陶葆楷	人物
胡镇埔	人物
吴通微	人物
张钰钟	人物
赵琦美	人物
谢晶曦	人物
阎又文	人物
赵博宣	人物
崔尚斌	人物
苏宜	人物
耶律隆绪	人物
捶床捣枕	词语
梁一儒	人物
潘乃德	人物
黎遇航	人物
李彝超	人物
胡汝嘉	人物
李佛金	人物
家公	词语
桓赫	人物
搭手	词语
沈家祥	人物
何必当初	词语
路断人稀	词语
顾真安	人物
卫长公主	人物
马中苏	人物
苦境	词语
lrma	人物
丘浚	人物
肖霖生	人物
伊藤由奈	人物
邓绥	人物
巴三览四	词语
甘言美语	词语
刘芳艳	人物
离弦	词语
徐淑	人物
雨鬓风鬟	词语
笔路	词语
知遇	词语
陈其昌	人物
苏元章	人物
李佳白	人物
奴颜媚骨	词语
乔培新	人物
理屈	词语
涓埃	词语
陈循	人物
余永宁	人物
王殿海	人物
一言丧邦	词语
笨鸟先飞	词语
千斤重担	词语
权宜	词语
郭霍	人物
真意	词语
风樯阵马	词语
朱翔宇	人物
百无一成	词语
参商之虞	词语
吕建刚	人物
张虔生	人物
李醉梅	人物
曾连荪	人物
当头	词语
张景龄	人物
子胥	词语
秦晓	人物
范云六	人物
滕维藻	人物
李太忠	人物
何景熙	人物
吴银实	人物
徐名秋	人物
冯鉴强	人物
宋庠	人物
谭自烈	人物
圆滑	词语
快语	词语
苏瑰	人物
瞎抓	词语
鱼龙曼羡	词语
李桅	人物
大处着眼	词语
王天雍	人物
吉田兼好	人物
杨景贤	人物
高鹗	人物
冯树功	人物
库利吉	人物
陈翠婷	人物
比手画脚	词语
违天害理	词语
虚情假意	词语
柏盟鸥	人物
赵伊坪	人物
矜功负气	词语
走步	词语
神态自若	词语
田谦	人物
武承嗣	人物
王赣	人物
洪颐煊	人物
王母娘娘	人物
俊雅	词语
沈润	人物
李金华	人物
抹不开	词语
一呼百诺	词语
陈际瓦	人物
舒芬	人物
康笑胤	人物
黄士俊	人物
曹棘	人物
余嗣贵	人物
孙羹笼	人物
怀进鹏	人物
邱振亮	人物
刘子铸	人物
姚秦	人物
梁开国	人物
于天文	人物
留滞	词语
陈学玺	人物
宋兆钦	人物
天秀尼	人物
李贻德	人物
了不得	词语
魏成富	人物
雨烟	词语
杨洁篪	人物
惹祸招殃	词语
张大方	人物
休兵罢战	词语
海角天隅	词语
郭玉良	人物
巴代	人物
刘祁	人物
邵圣懿	人物
toshiya	人物
忤逆	词语
汪东兴	人物
陈德权	人物
裴丽生	人物
李林甫	人物
江裕华	人物
施保昌	人物
李渤生	人物
荒寒	词语
沈善登	人物
周玉蔻	人物
羊士谔	人物
张文台	人物
不紧不慢	词语
董孝芳	人物
碧夏	人物
冯公智	人物
张孔修	人物
汪圻	人物
方浩然	人物
吴乃宪	人物
多此一举	词语
贾石	人物
汪潭民	人物
尚达奉	人物
振振	词语
僵滞	词语
辱国殃民	词语
币帛	词语
黄君珏	人物
流水落花	词语
纵横开阖	词语
广钦	人物
张仁铎	人物
永劫沉轮	词语
张放平	人物
吴敦义	人物
体念	词语
哈斯特尔特	人物
程坤	人物
陈再励	人物
林修德	人物
好像	词语
雅玉	人物
驰志伊吾	词语
傍花随柳	词语
陈纯一	人物
周序鸾	人物
侯霸	人物
李兆权	人物
瑞斯	人物
贤德	词语
提法	词语
童金苟	人物
李文察	人物
宋瑞祥	人物
磨刀不误砍柴工	词语
郭起元	人物
方登峄	人物
皇恩	词语
卢克焕	人物
王兴周	人物
吴理真	人物
刘将闾	人物
陈玉全	人物
谈振辉	人物
赵汾浦	人物
余光茂	人物
黄健翔	人物
痛哭流涕	词语
扯后腿	词语
保境息民	词语
柳宗元	人物
陈少锐	人物
科斯托夫	人物
朱蓓薇	人物
不觉技痒	词语
田小军	人物
尽数	词语
北静王	人物
藏弓烹狗	词语
赵炳安	人物
赵持满	人物
贝克西	人物
归罪	词语
安峰石	人物
赵孝	人物
乌尔班	人物
舍旧谋新	词语
立功赎罪	词语
伊蕾	人物
阿比丁	人物
西中文	人物
俚歌	词语
石三友	人物
路惠男	人物
苍华	词语
耻笑	词语
慎终承始	词语
何景福	人物
孔文森	人物
暗喜	词语
萧统	人物
老弟	词语
袁湘	人物
程彪	人物
彭小枫	人物
章衡	人物
累教不改	词语
吵吵	词语
彭启丰	人物
宋任穷	人物
徐之范	人物
何基沣	人物
不学无术	词语
张乐军	人物
楼云	人物
翟玉娟	人物
乘龙佳婿	词语
顺风使帆	词语
刘智泰	明星
侯显	人物
陈宏绪	人物
金宇中	人物
符敦秀	人物
周弼	人物
后尘	词语
谢凡	人物
闲言碎语	词语
金问泗	人物
朱印然	人物
杨佑之	人物
胡如忠	人物
贝托莱	人物
王水莲	人物
严敦易	人物
吴恒泰	人物
叶松盛	人物
安万铨	人物
奥尔洛夫	人物
砥节励行	词语
单德彬	人物
越吉	人物
张维石	人物
炙鸡渍酒	词语
林玉兴	人物
玄青	词语
里德伯	人物
棍	词语
希罗多德	人物
陈金声	人物
高雪岚	歌手
王筱芸	人物
石琚	人物
李文奎	人物
佟大为	明星
千回百转	词语
韦季	人物
羊昙	人物
刘青藜	人物
柳弘	人物
阳球	人物
示人	词语
俞灏明	演员
黄铭新	人物
王月珠	人物
施艾敏	人物
栗在山	人物
寇庆延	人物
白幼蒂	人物
必备	词语
马炳元	人物
饮子	词语
安志文	人物
不怀好意	词语
华平澜	人物
喜形于色	词语
水滴石穿	词语
林一山	人物
杳不可闻	词语
查为义	人物
无所作为	词语
朱元暹	人物
靖志远	人物
凉津津	词语
匀整	词语
尹素怡	明星
崔生	人物
禁绝	词语
连晓	词语
困知勉行	词语
相忘形骸	词语
刳胎焚夭	词语
难解难分	词语
饶碧友	人物
蜡白	词语
谢高觉	人物
哭丧棒	词语
竺法兰	人物
姚喜明	人物
白养珍	人物
画地刻木	词语
张泊生	人物
卢钟鹤	人物
管震湖	人物
薛泽	人物
伍铁如	人物
明通	词语
常仲连	人物
加以	词语
黄鹤翔	艺人
流泻	词语
刘土光	人物
章良能	人物
朱樟	人物
青龙金匮	词语
孔德萍	人物
杨采妮	明星
张力田	人物
林尊	人物
王胜朝	人物
甘渭汉	人物
罗世生	人物
鼠胶	词语
汪铎洋	人物
卡雷尔	人物
长亭	词语
李洪珍	人物
陆完	人物
目无余子	词语
卓晚春	人物
王廷秀	人物
李铁君	人物
姜容樵	人物
李道士	人物
朴新阳	明星
朱道华	人物
软裘快马	词语
林向群	人物
屈臣氏	著名品牌
甄美莉	人物
王二小	人物
石成瑞	人物
许兆焕	人物
支配	词语
孙天放	人物
大厦将倾	词语
刘永佶	人物
万绮雯	明星
山谦之	人物
风趣	词语
刘祖培	人物
