梁启超	人物
梅小青	人物
唐基明	人物
李锦梅	人物
吴秀波	人物
廖学秋	人物
孙正阳	人物
黄杏秀	人物
张雨绮	人物
李铭顺	人物
肖开愚	人物
程玉菁	人物
薛媛	人物
余洪元	人物
金善	人物
立威廉	人物
杨子姗	人物
李绵璐	人物
周启明	人物
冯德英	人物
金侃	人物
孙绍振	人物
佘诗曼	人物
马立诚	人物
师松龄	人物
林迪安	人物
陈运彰	人物
张燕瑾	人物
何金海	人物
芦边拓	人物
王桂发	人物
杨步亭	人物
朴真熙	人物
王芝泉	人物
小人物	人物
林昆	人物
周嘉玲	人物
王拙	人物
孙玉明	人物
林锦堂	人物
仲盛珍	人物
羊兰芬	人物
哈元章	人物
柏安妮	人物
吕利	人物
吕纪	人物
马瑞芳	人物
汪永江	人物
朱公瑾	人物
刘铭恕	人物
周濯街	人物
傅颖	人物
李国彝	人物
吴基焕	人物
苏曼殊	人物
汪关	人物
王荣山	人物
梁咏琪	人物
钱家祥	人物
刘沧浪	人物
刘述先	人物
洪天照	人物
宋慈	人物
范凤翼	人物
姚谦	人物
徐有光	人物
马俊山	人物
赵五娘	人物
柯奂如	人物
董德存	人物
金一甫	人物
蒋介石	人物
成宥利	人物
徐平羽	人物
孙华炳	人物
卢邈	人物
无厘头	人物
牛龙菲	人物
尹恩惠	人物
谭希培	人物
熊大木	人物
谢柏梁	人物
吕抚	人物
吴浩康	人物
韩子康	人物
陈应芬	人物
黄世仲	人物
左晟	人物
黄玉珊	人物
马晋卿	人物
刘体智	人物
薛逢春	人物
陈翘	人物
王肯	人物
林宥嘉	人物
孔庆全	人物
邵弥	人物
张月胜	人物
刘临	人物
任惠中	人物
秋成勋	人物
严澍	人物
刘长乐	人物
袁翰青	人物
邵恒秋	人物
转语	词语
温朱万	人物
徐培三	人物
辛桐	人物
万汇	词语
黄嘉树	人物
金启	人物
贺名仑	人物
王大经	人物
唐琼	人物
佩尼亚	后卫
徐尚田	人物
刘鹤年	人物
徐赫	人物
赵光涛	人物
殷树柏	人物
宋四家	人物
韦卓民	人物
任法融	人物
宋庆龄	人物
陈佐湟	人物
包忠文	人物
宝生舞	人物
傅增湘	人物
李佐贤	人物
张紫晨	人物
王羚柔	人物
吴仲良	人物
曾荣华	人物
鹿逊理	人物
孔厥	人物
钱光培	人物
童少生	人物
谢旦如	人物
邵循正	人物
孙桂	人物
斯民三	人物
富连成	人物
斯凯奇	人物
埃林顿	人物
李富孙	人物
谌德容	人物
姜亮夫	人物
胡玉芳	人物
赵修民	人物
徐天新	人物
江口洋介	人物
田永善	人物
何晓青	人物
马采	人物
罗锐	人物
冯钧	人物
居简	人物
王炜钰	人物
罗贤佑	人物
陈邕	人物
闻声相思	词语
李葆嘉	人物
阎学通	人物
于黑丁	人物
宋在胤	人物
郑艳丽	人物
森本薰	人物
袁澄	人物
陈立清	人物
郝培文	人物
金可久	人物
施忠	人物
弄性尚气	词语
管晓宏	人物
百不一贷	词语
光良	音乐
陈吉宁	人物
师子	词语
邱纯甫	人物
维尔哈伦	人物
刘华才	人物
折足覆餗	词语
张丹露	人物
以刑止刑	词语
刘宰	人物
德清大师	人物
邵博	人物
小野洋子	人物
木子美	人物
林韵	人物
哈德成	人物
刘彦斌	人物
林鸿增	人物
左辅右弼	词语
叶梅新	人物
马儒沛	人物
背前面后	词语
孙智敏	人物
暗香疏影	人物
翁守瑜	人物
仇晓	人物
蔡淳佳	人物
万芳	人物
白衣公卿	词语
老调重谈	词语
贯穿今古	词语
悖言乱辞	词语
叶佳修	音乐
毛建儒	人物
杨虑	人物
江德量	人物
解夏草	词语
新词	词语
变化如神	词语
蒋宏杰	人物
潘天耕	人物
严济	人物
江蕙	歌手
惧内	词语
史光柱	人物
风清扬	人物
逞奇眩异	词语
贵庚	词语
舒慧	人物
许云峰	人物
逐末忘本	词语
萨丕尔	人物
罗天婵	歌唱家
器满则覆	词语
张幼文	人物
萧荫堂	人物
宋柏年	人物
济弱扶倾	词语
指东画西	词语
赵君陶	人物
钱志道	人物
尹昌隆	人物
陈光虎	人物
李光羲	歌唱家
一夕一朝	词语
范先佐	人物
刘宝镛	人物
郭明辉	人物
乐天宇	人物
范野	人物
罗康瑞	人物
百年之柄	词语
冷僻	词语
田晓文	人物
一朝之患	词语
周京	人物
惠士奇	人物
鼎铛有耳	词语
可悲	词语
知我罪我	词语
一字师	词语
杜永峰	人物
正心诚意	词语
出息	词语
陶培麟	人物
老手	词语
黄时枢	人物
冯钟璞	人物
杜渐防萌	词语
顾立基	人物
纳瓦伊	人物
沈宗瀚	人物
冯国旺	人物
杂说	词语
东床坦腹	词语
桀骜难驯	词语
重义轻生	词语
施耐庵	著名作家
正色敢言	词语
儆戒	词语
洞烛其奸	词语
玩意	词语
佛头着粪	词语
自觉形秽	词语
怙终不悛	词语
越民义	人物
冯恩	人物
叶圭祥	人物
好生之德	词语
朝穿暮塞	词语
尤老娘	人物
饭袋	词语
高继宣	人物
袁服孔	人物
孙兰嫒	人物
食日万钱	词语
马金镖	人物
毕玉蓉	人物
以半击倍	词语
炒冷饭	词语
杀气	词语
积重难反	词语
别克	汽车品牌
阎崇琚	人物
范隆坤	人物
吕韵季	人物
平龙	人物
黄中岳	人物
别有心肠	词语
苏启强	人物
曹家鼎	人物
飞鸟依人	词语
张宇豪	明星
姚奎英	人物
文诚熏	人物
林威助	人物
丁言仁	人物
王心阔	人物
范庭玉	人物
神谋魔道	词语
云屯飙散	词语
苏文举	人物
根株牵连	词语
博识多通	词语
遁世离群	词语
金田一一	人物
乐以忘忧	词语
一言兴邦	词语
胡老爷	人物
裨益	词语
熊赣湘	人物
林宸希	音乐
林祁	人物
矜平躁释	词语
郭顶	歌手
米伦	人物
心甜	词语
steelheart	音乐
蔡其瑞	人物
史念海	人物
精悍	词语
云涌飙发	词语
料敌若神	词语
鼻子眼儿	词语
吴子彬	人物
琐言	词语
邵新民	人物
王炳根	人物
许永生	人物
龙安志	人物
王久源	人物
泥塑木雕	词语
闭门酣歌	词语
尚慧敏	人物
镲	民族乐器
伴食宰相	词语
于涛方	人物
烈烈轰轰	词语
柳斌杰	人物
晓得	词语
顾影弄姿	词语
漫天蔽野	词语
惝恍迷离	词语
白首穷经	词语
大金刚	人物
孙钿	作家
那英	音乐
徐君伍	人物
樱井翔	人物
凌昌全	人物
刁寒	歌手
邬宝恒	人物
刘作斌	人物
立言	词语
金瓯无缺	词语
机变如神	词语
叶又新	画家
好酒贪杯	词语
五里雾中	词语
马泰泉	人物
陈嘉庚	人物
尹积昌	雕塑家
速成	词语
白蔹	中药
莫时仁	人物
磊落豪横	词语
石晶晶	人物
严迅奇	人物
王万钟	人物
步弓	词语
陆永昌	人物
冯集梧	人物
何润东	歌手
shania	人物
王兴超	人物
中国娃娃	卡通人物
陈纯甄	人物
李建萃	人物
刘子衡	人物
林乐义	人物
边景召	绘画
吴天麟	人物
苏符	人物
李象坤	人物
董方卓	体育明星
色授魂与	词语
葛墨林	人物
钱钟韩	教育家
贪墨成风	词语
韦拔群	人物
以权达变	词语
历落	词语
海水群飞	词语
苍生涂炭	词语
吴天石	教育家
欧阳丹彤	人物
诺氟沙星	抗生素
开来继往	词语
李诗韵	明星
祝庆英	翻译家
屠伯	人物
王贺炬	人物
史万春	人物
曹茂君	人物
梁咏琪	音乐
和平县	河源
赵常贵	人物
何孟雄	人物
玉紫岩	山
黄选平	人物
竹节参	中药
童诗白	人物
宫雪花	香港艺人
农郊	词语
平希豫	人物
永世无穷	词语
明党参	中成药
伍仕贤	明星
郑魁	人物
白庚延	中国画
后悔药	词语
刘亚兰	人物
八面威风	词语
萧重望	人物
阑槛	词语
苏迟	人物
典章文物	词语
维纳	人物
辱门败户	词语
知人论世	词语
严复	翻译家
马雅舒	明星
左建明	人物
陈蝶仙	作家
钟佐泓	音乐
闫妮	明星
标新领异	词语
海金沙	中成药
东野圭吾	作家
翕然	词语
喜乐	词语
反比	术语
张帝	台湾歌手
李宝台	人物
密蒙花	中药
罗家英	明星
张译	明星
神谷明	人物
相配	词语
奋袂	词语
优孟衣冠	词语
民生国计	词语
王禄江	港台明星
张芝庭	人物
蔡心耜	人物
李悦娥	人物
东生	人物
食宿相兼	词语
时不我与	词语
朱媛媛	明星
祝萃	人物
黄秀贞	明星
庄前鼎	人物
绝粒	词语
囊萤照读	词语
钱惟善	人物
赵大年	著名作家
洪周禄	人物
舒同	人物
于明信	教育家
熊天平	台湾歌手
玩物丧志	词语
飘萍断梗	词语
刘理德	人物
博学	词语
涂学忠	人物
白芨	中药
编者	词汇
秦大河	人物
梁冠华	明星
黄汲清	人物
弘景	人物
宗江	人物
嘉容	词语
