缅甸	国家
挪威	国家
斯洛伐克	国家
正定县	行政区划
塞浦路斯	国家
怒族	民族
突泉县	行政区划
武篆镇	行政区划
花溪区	行政区划
舞钢	行政区划
唐河县	行政区划
安义县	行政区划
马尾区	行政区划
平邑县	行政区划
河南蒙古族自治县	行政区划
南郑县	行政区划
武邑县	行政区划
汲县	行政区划
西樵镇	行政区划
四方台区	行政区划
永修县	行政区划
宁津县	行政区划
隆江镇	行政区划
冷水江	行政区划
涟源	行政区划
桦南县	行政区划
溆浦县	行政区划
全南县	行政区划
阿克塞哈萨克族自治县	行政区划
威县	行政区划
宋溪镇	行政区划
辽中县	行政区划
安西县	行政区划
宝圩镇	行政区划
香花镇	行政区划
冉义镇	行政区划
六合区	行政区划
沙湾县	行政区划
稷山县	行政区划
临湘	行政区划
滦县	行政区划
博爱县	行政区划
离石区	行政区划
黎村镇	行政区划
邹桥乡	行政区划
沿滩区	行政区划
沧源佤族自治县	行政区划
清州镇	行政区划
徐汇区	行政区划
华容区	行政区划
翔安区	行政区划
江东区	行政区划
蓬安县	行政区划
鲁山县	行政区划
枋洋镇	行政区划
安亭镇	行政区划
梁平县	行政区划
澄海区	行政区划
川汇区	行政区划
安仁县	行政区划
青神县	行政区划
慈利县	行政区划
祥芝镇	行政区划
盘龙区	行政区划
歙县	行政区划
南木林县	行政区划
麋鹿	动物
洮北区	行政区划
坦桑尼亚	国家
马边彝族自治县	行政区划
包屯镇	行政区划
冯川镇	行政区划
临泽镇	行政区划
成华区	行政区划
横扇镇	行政区划
固阳县	行政区划
辉南	行政区划
后里乡	行政区划
阳峪镇	行政区划
夏茂镇	行政区划
郑庄乡	行政区划
南宁	城市
临淮镇	行政区划
潭埠镇	行政区划
耿马傣族佤族自治县	行政区划
黄花菜	蔬菜
汪洞乡	行政区划
崇仁县	行政区划
本溪满族自治县	行政区划
县辖区	行政区划
囊谦县	行政区划
椒江区	行政区划
彰化县	行政区划
九亭镇	行政区划
代县	行政区划
白菜	蔬菜
沙敦府	行政区划
府谷县	行政区划
吉隆县	行政区划
车江镇	行政区划
王家营	行政区划
柳山镇	行政区划
黄宅镇	行政区划
蛔虫	疾病
科尔沁右翼前旗	行政区划
宣武区	行政区划
贤官镇	行政区划
蔡家站	行政区划
沈河区	行政区划
龙川乡	行政区划
木奇镇	行政区划
举重	体育运动
塞诺	行政区划
经楼镇	行政区划
达吉斯坦共和国	行政区划
土库曼斯坦	行政区划
安戈谢	行政区划
东戈壁省	行政区划
卤代烃	烷烃
古田	行政区划
马塔迪	行政区划
沙缴府	行政区划
水痘	疾病
橄榄油	植物油
乔利乡	行政区划
代森锰锌	杀菌剂
坦桑尼亚	行政区划
鱼露	黄酒
鞋柜	橱柜
沙巴州	行政区划
阿干镇	行政区划
匡堰镇	行政区划
强迫症	精神疾病
氧化铁	氧化物
强迫症	心理疾病
黑色素瘤	疾病
抗氧剂	化学品
网球肘	疾病
聋哑症	疾病
痔	疾病
三氧化硫	化合物
原木	木材
蚕豆病	疾病
股票交易	外汇
竹沟镇	行政区划
白癜风	皮肤病
折扇	扇子
亮氨酸	氨基酸
查尔斯顿	行政区划
睑腺炎	疾病
添加剂	化学品
瓜德罗普	行政区划
萨摩亚	行政区划
挪威政府	国家
扁平疣	皮肤病
博美犬	狗
痛风	常见疾病
六小龄童	演员
朊病毒	蛋白质
郑则仕	演员
毕浦乡	行政区划
电磁波	能量
白酒	饮料
水煎包	面食
奥文多	行政区划
霰弹枪	武器
李冰冰	演员
银耳	蘑菇
干细胞	细胞
氧化乐果	杀虫剂
菌核病	病害
聚氯乙烯	塑料
淡菜	海产品
口眼歪斜	疾病
秀山	行政区划
多米尼加	行政区划
圣迭戈	行政区划
氢氟酸	化合物
透辉石	矿物
土壤结构	土壤
脲醛树脂	化学品
美元	货币
香菇	蘑菇
君主立宪制	政体
保守疗法	治疗
次氯酸钠	消毒剂
葡萄胎	妇科疾病
圆凿	天成轩
北京青年报	报纸
尼姆鲁兹省	行政区划
宇宙论	术语
兵役制度	制度
轮作	作物
沉积岩	岩石
做市商	外汇
三明治	食品
赤铁矿	矿物
江泽林	领导
香兰素	食品
灵华山	山
霰弹	弹药
隐私权	权利
豆芽菜	蔬菜
沈培艺	演员
放火罪	犯罪
雷司令	白葡萄酒
廊	建筑
彩电	家用电器
匈奴	民族
驻马店	城市
棒球	体育项目
弹性元件	弹簧
伍伦贡	城市
何仙姑	神仙
菌株	细菌
足癣	常见疾病
二氧化钛	化合物
肽	蛋白质
肝脏	器官
汇丰银行	银行
曹骏	演员
滑板车	运动器材
天然纤维	纤维
草鱼	淡水鱼
烙饼	面食
创业板	中小企业
系统集成	智能建筑
象形文字	文字
铁矿石	矿石
环氧氯丙烷	化学品
熟女	女人
酸根	离子
周美玲	导演
云锣	乐器
密支那	城市
小黄鱼	淡水鱼
双翅目	节肢动物
应采儿	演员
中国工商银行	中国银行
海鳗	淡水鱼
睾丸癌	癌症
一氧化二氮	气体
朱鹮	游禽
半翅目	动物
古晋	城市
唐山大兄	电影
贝类	动物
石岩枫	大戟科
姐妹节	民族
中央处理器	微处理器
伊利石	矿石
雪宝顶	雪山
疟疾	常见疾病
中国银行	银行业务
小笼包	包子
电线电缆	电线
电磁场	电学
打击乐	音乐
财团	垄断
过桥米线	特色小吃
bios	技术
胃痛	常见疾病
糜棱岩	岩石
鳙鱼	淡水鱼
中秋节	节日
绞股蓝	葫芦科
丁醛	化学品
中秋节	圣诞节
白血病	癌症
胡桃	中药材
桑皮纸	造纸
苯乙烯	化学品
完颜雍	皇帝
万学远	领导
夏令营	活动
磷化氢	化合物
唐山大兄	影片
辉县	城市
台灯	灯具
花生	食品
绿松石	宝石
光大银行	商业银行
评剧	戏剧
儿童玩具	玩具
庐山	灵山
程小东	张艺谋
乳腺癌	癌症
即兴曲	乐曲
二十四史	书籍
火山锥	火山
奶昔	饮料
虎纹蛙	动物
火烈鸟	鸟类
宇文邕	皇帝
酸角	农产品
郭蔼明	美女
电源	开关电源
涪城区	政区
磁选	选矿
民事诉讼	诉讼
雪顿节	民族
铬酸	化学品
凉皮	小吃
秦颂	影片
杨思琦	演员
寄生虫病	疾病
瓜亚基尔	行政区划
布艺	窗帘
加拉加斯	城市
给排水	市政
舞狮	舞蹈
棕竹	花卉
氮芥	抗癌药
邰丽华	舞蹈演员
杨钰莹	歌手
西芹	农产品
国家税务总局	政府部门
童小平	领导
荠菜	野菜
氢氧化钾	化合物
全椒县	县
苄嘧磺隆	农药
豆豉	食品
胸胁	疾病
黑叶猴	动物
柠檬酸三乙酯	化学品
大昭寺	寺院
林少春	领导
籽棉	棉花
米糠油	油脂
喉癌	常见疾病
膀胱炎	肾病
松狮犬	宠物狗
吊灯	灯具
贡菜	蔬菜
透闪石	矿物
蔡依林	台湾歌手
玉皇大帝	神仙
豆渣	食品
林迪安	导演
钙	还原剂
兜兰	植物
帕玛拉特	企业
锡伯族	少数民族
芦竹	植物
80286	微处理器
加饭酒	酒类
氯酸钾	钾盐
板胡	乐器
金鱼藻	植物
湘语	方言
氧化镁	化学品
罗志祥	演员
湄公河	河流
首脑	政党
美林公司	金融公司
成宥利	女明星
四书五经	教育史
铁人三项	体育项目
汽车玻璃	玻璃
奶酒	酒
茅胜奎	演员
数据源	数据库
甜瓜	农作物
钠	元素
天然气	石油
水杨醛	化学品
气瓶	装置
西夏文	文字
小戏	戏剧
执壶	瓷器
鸣禽	动物
湘军	军队
痤疮	青春痘
碳酸	化学品
建筑面积	装修
花生仁	食品
克洛维	国王
陈欣健	配角
企业形象	企业
主食	食物
十六醇	化学品
美国众议院	国会
企业信用	信用
科希马	地区
戴阳天	演员
素油	食物
粤语歌	歌曲
盐酸	化学品
酸奶机	机器
袜子	日用品
李辉英	作家
吕祖善	领导
臭椿	树种
马来西亚	新加坡
南锡	城市
伏明霞	体育明星
孙文婷	美女
德天瀑布	瀑布
环己酮	化学品
山罗花	玄参科
绿藻	藻类
硝酸铅	化学品
硕士	研究生
龙港区	区划
白虎风	疾病
马齿苋	蔬菜
犬科	哺乳动物
陈酿	酒
冯志丰	童星
乙酸酐	化学品
学	知识
猪笼草	草本植物
丑女	女人
人格特质	人格
潇湘晨报	媒体
北京市回民学校	学校
和服	服装
汉沽区	区划
犹太人	犹太
菏泽	城市
新兴产业	企业
汽艇	交通工具
弹道导弹	军事装备
葛民辉	周星驰
凉果	蜜饯
通货膨胀	汇率
支线	运输
反证	证据
阿拉伯海	海域
达尼丁	行政区划
宝顶山	石刻
富士银行	银行
帕萨迪纳	城市
花面狸	动物
萨姆松	城市
熊岳温泉	温泉
浦北县	县
张懿婧	演员
乐活族	群体
华商报	媒体
胭脂鱼	鱼类
杏梅	梅花
信天翁	动物
铃木保奈美	演员
朱执信	辛亥革命
薛觉先	戏剧
盖浇饭	小吃
核电机组	核电
颜冠英	演员
戴玉强	男高音
帕多瓦	城市
遗产税	税种
开斋节	传统节日
八角鼓	音乐
音箱	电子产品
应城	区划
红露珍	花卉
松江区	城区
中国国民党	政党
花蕊石	中成药
王伍福	演员
罪名	刑法
一汽集团	汽车
南瓜饼	南瓜
中国建筑装饰协会	行业协会
抽屉锁	锁具
牙本质	牙齿
萱草	中药材
容小意	演员
化学纤维	纤维
哈雷彗星	彗星
报关	进出口
贺友直	连环画
联合国儿童基金会	基金会
黑水鸡	动物
夏士莲	产品
解放日报	宣传
毕方	妖怪
传单	宣传
卫匡国	传教士
数据处理	术语
黄平方	领导
沭阳县	县
哒螨灵	农药
腾格尔	音乐
秃鹳	陆禽
贝克休斯	石油
科斯迈尔	企业
百草枯	除草剂
苯并咪唑	化学品
资产重组	资产
蓝线石	宝石
武正豪	演员
摩加迪沙	索马里
香港会议展览中心	湾仔
炻器	制品
钙	化学元素
对苯醌	化合物
低音提琴	乐器
