雁荡山	地理
超线程	计算机技术
代码	计算机技术
磁盘碎片	电脑
足癣	应用科学
被动语态	语法
宾语	英语
犹太教	以色列
冰肌玉骨	典故
吹毛求疵	文化
从善如流	词语
衣原体	分子生物学
外挂	程序
耳鬓厮磨	文化
摩登舞	体育
水门事件	事件
勾股定理	历史
原教旨主义	伊斯兰教
市侩	汉语
血小板	健康
行货	经济
智能手机	手机
植眉	美容
双百方针	文艺
cm	同人
无欲则刚	成语
硫代硫酸钠	营养学
电离辐射	内科学
网页	电脑
域名	通信
白平衡	数码相机
狼孩	环境
日心说	标准
糖尿病	营养学
系数	物理化学
鸡眼	健康
心悸	医学
驱动程序	计算机
线程	科学
年号	历史
年号	传统
艾窝窝	北京小吃
五体投地	典故
ddr	网络
gpu	显卡
直线运动	科学
南通	中国
小户型	建筑业
维基百科	网站
火把节	少数民族
败北	历史
赤道	自然科学
gprs	手机
茅台	饮食
胰岛素	医疗
胰岛素	健康
路由器	电子
冷金	历史
分频器	视频
饮茶	茶叶
燃料电池	化学
合同法	社会
抑郁症	心理健康
胆红素	营养学
气胸	应用科学
wikipedia	维基
大理石	装修
拉卜楞寺	宗教
网络电话	流行语
粉领	职业
杨尚昆	政治
乔石	博山
王兆国	履历
成思危	风险投资
陈至立	女性
徐才厚	人物
霍英东	传记
中华人民共和国中央军事委员会	军事
冰川	环境
郑和	人物
刘师培	经学家
梁启超	人物
高亨	吉林
冯友兰	河南人
冯友兰	残疾人
比基尼	生活
旧石器时代	古文明
福建农林大学	福建
广告	职业
winrar	计算机技术
微软	电脑
微软	技术
陆游	著名作家
雅虎	技术
梁咏琪	人物
博斯腾湖	地理
纳米比亚	英联邦
胡扯	词典
坦桑尼亚	莱索托
柳宗元	人物
丁肇中	物理学家
丁肇中	诺贝尔奖
腊八节	生活
促销	贸易
中秋节	月饼
岫岩满族自治县	省市
阿塞拜疆	地理
man	名称
man	技术
吉尔吉斯斯坦	地理
吉尔吉斯斯坦	旅游
印度尼西亚	石油输出国组织
书	语言
任天堂	游戏
达斡尔族	文化
朝鲜族	中国
百脉泉	山东
袁崇焕	将领
亚洲	自然地理
显微镜	应用科学
复调	音乐学
赵雅芝	艺术家
马耳他	旅游
南美洲	地理学
北京邮电大学	邮电
黄湘怡	港台明星
编程	应用科学
计算机	自然科学
曹娥格	文学
燕尾格	灯谜
栾川县	地理
林月如	文化
光良	音乐
电子	诺贝尔奖
网络	互联网
网络	网络安全
宪法	法律
巩俐	山东人
眉毛	自然科学
亳州	安徽
三顾茅庐	文学
阳煤集团	领导
东京大学	中国工程院
量子化学	自然科学
纪伯伦	文学
鄂毕河	俄罗斯
鄂毕河	地理
阿昌族	历史
电化学	物理学
布依族	历史
闫妮	明星
江苏	华东
梁冬	互联网
五行	应用科学
沃尔沃	公司
沃尔沃	生活
恶搞	流行语
埃及	地名
忍辱	佛教
硫酸钾	自然科学
沙溢	艺人
八神庵	拳皇
汉服	文化
中央音乐学院	教育
云南农业大学	大学
普通话	语言
新闻联播	电视栏目
拉祜族	地理
东北虎林园	风景区
china	社会主义
金丝小枣	生活
生产力	社会
那达慕	生活
怒族	历史
甲醛	化学
方力钧	艺术工作者
蛋雕	工艺美术
三氧化二砷	化学
hyde	明星
佤族	中华民族
保亭花	花
俞平伯	名人
光盘	科学
声乐	艺术
光纤	金属
罗贯中	明星
内蒙古	文化
拒马河	自然科学
绫波丽	女神
讲师	应用科学
福娃	奥林匹克运动会
理发	发型
湖南大学	中国大学
信用证	经济
诈骗罪	法律
薄熙来	人物
三亚	旅游胜地
兼职	四川大学
微波	物理学
西昌	地理
水木年华	明星
密西西比河	地理学
writely	google
2008	科学
蒋介石	人物
衬托	文学
变星	自然科学
唯心主义	生产
富士山	文化
建筑节能	高新技术
液晶	科学
重庆大学	社会
狗肉	生活
邓州	城市
西北工业大学	中国大学
尹恩惠	人物
荷兰	世界贸易组织
黄花闺女	称谓
宋四家	人物
海螺沟	中国
河外星系	科学
丹麦	地名
现实主义	文学
蚌埠	安徽
中国国家航天局	航空航天
西沙群岛	海洋
道教	道术
刘勰	山东人
陕西历史博物馆	西安
刘歆	天文学家
子安武人	cv
体育运动	球星
欧元	欧盟
八仙花	中药
布加迪	机械
网虫	因特网
大叶黄杨	生物
通话时间	数码
吉普车	品牌
宽容度	文化
石竹	国花
萧亚轩	舞蹈
海子	诗歌
机车	潜艇
虚拟现实	电子技术
立威廉	人物
唐禹哲	港台明星
送礼	礼品网
井上雄彦	明星
犹太人	巴勒斯坦
曲阳县	河北
包拯	忠臣
笔记本电脑	计算机科学
斐济	世界
雅虎	技术
耶律楚材	元朝
不丹	地理
以色列	世界贸易组织
贺双卿	词人
关智一	cv
官厅水库	水文学
上网	时尚
烤乳猪	菜谱
电鳗	物种
菠萝	美食
叶酸	科学
张泳	人名
芦荟	药品
清丰县	地理
信息系统	科学技术
犬儒学派	主义
婺源县	中华人民共和国
名吃	典故
启东	运动
启东	人才
数字地球	地球科学
五洲	人才网
基因	药理学
霍邱县	地理
林航	实业家
大跃进	中国
静脉曲张	健康
沈福彭	地理
东施效颦	词汇
zone	乐队
鱼鳞病	药品
艾滋病	医学
秋波	词典
秋波	爱情
罗大佑	音乐作品
旅游	术语
中国移动通信集团公司	计算机技术
冯钟璞	人物
广告主	社会
指令集	计算机技术
逾墙钻穴	文化
宇宙尘	天文学
十渡	交通
洪金宝	名人
坦噶尼喀湖	自然
鄙于不屑	文化
潘长江	明星
东北农业大学	教育
海森堡	诺贝尔奖
美人香草	词汇
兰博基尼	公司
机床	冶金
节理	自然
滑阀	机械零件
梅里雪山	地理
吴三桂	缅甸
水肿	营养学
除权	投资
碳氢化合物	科学
琅琊山	旅游
韩正	浙江
唐招提寺	艺术
冲浪	拳击
湖北美术学院	学院
邪教	法律
触摸屏	计算机技术
红筹股	建筑学
英国航空公司	社会
素鸡	饮食
纪昀	诗人
企业债券	社会
承销	经济
精油	美容
整理	建筑学
粉末冶金	机械工程
股息	金融
joga	足球
苯甲酸钠	医学
世界园艺博览会	自然
林觉民	烈士
惠普	数码
外销员	商品
盘古	神话
麻糖	生活
安徽大学	高等教育
生肖	文化
东北虎	虎
米酒	微生物
被子植物	林学
佟大为	男演员
佟大为	明星
万绮雯	明星
高压锅	物理
狴犴	龙生九子
胡芳芳	歌手
神社	建筑
半衰期	物理学
佳木斯大学	佳木斯
光电效应	诺贝尔物理学奖
一木难支	文化
金慧成	high
模式识别	电子技术
局域网	计算机
局域网	通信
美国中央情报局	历史
陈慧珊	港台明星
白鹇	中药
华为技术有限公司	经济
叶挺	军事家
贺军翔	艺人
湘绣	文化遗产
张自忠	民族英雄
明十三陵	旅游
清东陵	名胜
苹果公司	苹果电脑
劳力士	品牌
劳力士	生活
重婚罪	法律
曹骏	明星
鸡眼	健康
宿豫	地区
半双工	电子技术
驱动程序	计算机
缩聚反应	科学
博尔顿	体育人物
郓城县	旅游
竹琴	中国
竹琴	民族
萨芬	俄罗斯
现代诗歌	名称
唇裂	生物化学
景芝	中国
枫树	灌木
张文栋	中北大学
健身	气功
马六甲海峡	东南亚
pdf	常用软件
李双江	黑龙江人
红柳	饲料
大花脸	戏曲
ssl	信用卡
视频	计算机技术
巨野县	菏泽市
崔永元	名人
铅中毒	医学
董鄂氏	姓氏
快照	艺术
直销	网络
地动仪	历史
网络协议	名词
王涯	诗人
陆抗	三国
格什文	美国
西昆体	文学
于良史	诗人
虞世南	文学家
阻抗	心理学
汉剧	湖北
刘长卿	文化
金石滩	地理
陈子昂	唐朝
孟郊	文学
孟郊	著名作家
电池	生活
罗锐	人物
肉火烧	东北
佘诗曼	人物
闽剧	艺术
圆雕	雕塑
吴桥县	沧州
云锣	艺术
木结构	结构
安利	社会
伊朗	石油输出国组织
十八般兵器	成语
九章算术	历史
二氧化碳	分子生物学
上海理工大学	上海
土耳其	亚洲
土耳其	中东国家
摩尔定律	管理
脂肪肝	健康
健康	应用科学
箫	艺术
滤镜	信息技术
塔里木河流域	地理
那英	音乐
议论文	文体
帆船	航海
贺卫方	法学
荷叶茶	健康
团子	文学
许光达	大将
rle	文件格式
臭氧	科学
美元	美国
蒸汽机	世界史
和谐	网络
法系	社会
巴哥	宠物
手枪	火器
董仲舒	思想家
宇宙速度	天文学
锡金	雍和宫
负离子	生物化学
雷区	地区
映泰	电脑硬件
爱沙尼亚	东欧
渥太华	地理
日月山	地理
忍术	日本
catia	cad
五脏六腑	针灸
五线谱	乐理
硫酸铁	自然科学
重水	科研
维萨里	科学家
冉闵	名将
占星	星座
半导体	电子
紫仓	生物
毛泽东思想	毛泽东
石炭纪	科学
中东	旅游
中东	中东国家
太古宙	地球
支票	经济法
联合国安全理事会	委内瑞拉
谷氨酸	科学
阿空加瓜山	火山
河北正定中学	正定
马勃	生物化学
钱沣	书法家
明党参	中成药
牡丹皮	植物药
麦芽	中草药
评估	分子生物学
密蒙花	中药
路桥区	浙江
羚羊角	药品
奶昔	饮食
西班牙语	语言
心电图	生物学
罗布麻叶	医学
电饭锅	居家
杨玉环	人物
消化	词语
汽缸数	参数
墨尔本	地名
墨尔本	奥林匹克运动会
四川盆地	生产
花蕊石	植物药
花椒	美食
黄芩	植物药
新名词	社会
受精卵	应用科学
受精卵	神经科学
香槟	酒
强化食品	生活
秦始皇陵	文物
蒋大为	艺术家
班得瑞	乐队
djmax	网络游戏
音强	音乐
反舰导弹	军事学
寒山寺	艺术
巴哈马	旅游
蚜虫	农业
牛肝菌	蘑菇
原生动物	动物学
智能网	电子科技
赵盾	春秋
清真	社会
离合器	机械
股东大会	股票
比利时	地理
付佳	讲师
冬瓜	园艺
加蓬	不结盟运动
塞内加尔	不结盟运动
布隆迪	世界贸易组织
斯威士兰	地理
特立尼达和多巴哥	地名
卢巧音	设计师
段祺瑞	总理
鱼肝油	医学
雪肌精	生活
首都医科大学	社会
司马台长城	长城
劳动生产率	政治经济学
二恶英	医学
中古	词典
日冕	自然现象
阿尔泰山脉	地理
韩国泡菜	饮食
帕米尔高原	中东
送达	民事
佛山	广东
财政	科学
封转开	金融
比鲁尼	中世纪
木须肉	饮食
木须肉	食谱
歌仔戏	闽南语
橘子洲	景点
赫拉克利特	希腊
外交学院	外交
叶笃正	科学家
亚太经济合作组织	亚洲
杨虎城	陕西人
磁铁矿	机械
玛旁雍错	地理
八一建军节	节日
铀	化学
面相	交叉学科
国事访问	政治
明度	美术
抛光	数控机床
疾风知劲草	国学
福建柏	自然科学
阿拉伯语	沙特阿拉伯
weblogic	技能
出国	词语
刁寒	歌手
葛洲坝水电站	技术
荸荠	禾本科
东晋	朝代
梅毒	生物化学
晶胞	生物化学
视网膜	解剖学
太庙	庙会
叶群	政治
豆腐脑	饮食
尉迟恭	西游记
徐光宪	化学
汤显祖	明朝
声母	音韵
蔡锷	军事家
滑石	中药
海金沙	中成药
槐花	科学
射精	应用科学
阳江	旅游
盐亭县	地理
枸杞子	自然
陈友谅	人物
邗江区	地理
介子	光学
白芷	药品
血沉	医疗
拟态	昆虫学
声学	自然科学
蜂胶	昆虫学
豌豆黄	八大菜系
麻油鸡	美食
麻油鸡	饮食
灌肠	美食
蜀犬吠日	语言
过滤机	机械零件
构象	科学
绿豆	植物
net	电脑病毒
庄孔韶	教授
session	程序
望远镜	科学技术
硬件	船舶
混响	科学
灰鸽子	计算机
文君井	成都
安眠药	医学
陈嘉庚	人物
唾液	生理学
察哈尔右翼中旗	地理
泛音	自然科学
周杰伦	金曲奖
双绞线	机械
宿鸭湖	地理
棕榈	农作物
维纳	人物
皮肤	人体
核裂变	核电站
干宝	名人
南斯拉夫	意大利
党卫军	军事
党卫军	第二次世界大战
集合论	自然科学
支配权	法律
嘉善县	上海
闽江	地理
第二次世界大战	战役
苏古笃	音乐
苏古笃	艺术
半枝莲	花卉
动词	语言学
朱媛媛	艺人
朱媛媛	明星
痈	人体
mtu	网络
干城之将	文化
冰床	交通工具
复活节岛	太平洋
遂昌县	省市
轩辕丘	旅游
被选举权	法律
曹查理	港台明星
刑事责任	法理
荣国府	旅游
喷嚏	应用科学
二连浩特	地理
李霄鹏	人物
舍生取义	语言
耳环	时尚
天花粉	药品
尸僵	应用科学
捉贼捉赃	词典
华北电力大学	大学
易立	体育
许君豪	娱乐
逆温	科学
木子美	人物
杨利伟	名人
恩贾梅纳	乍得
二次污染	健康
布尔代数	科学
姬昌	名臣
卡南犬	宠物
自溶	法学
世界贸易组织	商务部
调虎离山	典故
无性生殖	物理化学
色谱法	科学
俞大猷	武将
希思	领导人
施艾敏	人物
脑死亡	应用科学
宫雪花	香港艺人
十字路	临沂
桑蚕	国学
叶绿体	自然科学
广播体操	锻炼
玉玺	印章
苦参	应用科学
螺栓	机械
刺五加	植物药
一枝黄花	中草药
呼兰区	地理
中亚	地理
东亚	朝鲜
比翼鸟	文化遗产
熊天平	台湾歌手
关天培	军事
后随链	遗传学
润滑	摩擦学
螨虫	疾病
别克	汽车品牌
雪佛兰	车辆
郭顶	歌手
瑞斯	人物
文明古国	国家
正正之旗	语言
安分知足	词典
安分知足	文化
赖氨酸	营养学
六礼	婚俗
芮城县	地名
祭司	宗教
问名	西周
黄芪	药品
瓯江	水文学
软锰矿	地质学
紧固件	五金
提篮桥	上海
红药水	生活
王母娘娘	人物
龟苓膏	中药
格物致知	成语
法显	佛教
新东方	培训
席慕蓉	散文家
纳征	礼仪
巴松措	西藏
阮志清	将领
阮元	书法家
杂食性	生物学
花露水	时尚
生物芯片	电子技术
董方卓	体育明星
贤内助	俗语
乳状液	分子生物学
扎兰屯	中国
汞	科学
波斯湾	亚洲
波斯湾	石油
他杀	词组
老河口	湖北
石耳	中药
杭州湾	旅游
地肤	学习
地肤	药品
透镜	自然科学
江口洋介	人物
内裤	服装
房改房	租房
地下室	建筑
朴新阳	明星
魔鬼城	新疆
魔鬼城	地理
监视居住	刑事案件
郁李	植物学
朴正哲	韩国
虎门	东莞
黄精	植物药
鲍叔牙	齐国
乌冬面	食物
殿试	动漫
翩翩起舞	成语
陈果夫	国民党
舒绣文	明星
汪延	新浪
冰球	冬奥会
海岩	编剧
构树	植物学
默克尔	德国
郎世宁	清朝
水飞蓟	药用植物
柘城县	商丘
试金石	岩石
蹼泳	游泳
苏辙	文学家
龙胜各族自治县	广西
红金龙	人物
茅莓	科学
免费软件	应用科学
穆斯林	伊斯兰教
细胞核	心理学
宾至如归	语言
蛇莓	生物
湖南卫视	技术
核仁	遗传学
哀而不伤	语言
水蛭	药品
水蛭	药用植物
安老怀少	词汇
傲骨嶙嶙	汉语
黯然伤神	文字
暗香疏影	人物
计划生育	政治
宝塔山	旅游
澳门大学	社会
小云雀	鸟纲
绘画	国画
嘉庆帝	人物
庞会	三国
黑翅鸢	自然
浑家	历史
吴姓	家族
光岳楼	历史
回鹘	中国
温病	医学
黄巾起义	历史
流体力学	物理
五言诗	文化
棕榈	科学
咸潮	地理
低音炮	电器
北固山	山脉
汇编	科学
苏曼殊	人物
脉动电流	机械
冯骥才	中国作家协会
干支	生肖
警种	词语
上海浦东发展银行	上海
钛铁矿	地球科学
地转风	自然现象
第四纪	生物化学
王实甫	历史
锗	自然
非洲联盟	经济
中国证券监督管理委员会	股市
动感地带	通讯
收益	会计
开诚布公	语言
宋任穷	人物
宋任穷	共产党
不结盟运动	机构
胡服骑射	服饰
钦博拉索山	山峰
多哈	世界
王城公园	洛阳
李盛霖	人物
亮度	物理学
陈炯明	民国
李金华	人物
孙家正	部长
会所	旅游
费玉清	音乐作品
招商局	股份公司
美洲豹	自然
矫诏	汉语
钟南山	医疗
花旗银行	经济
花旗银行	互联网
鲜车怒马	词汇
燃烧热	冶金
大调	音乐学
文殊兰	中草药
希勒	足球
陆莉	体操
孙晋芳	排球
张蓉芳	体育
物候	物理化学
放线菌	自然科学
螺旋体	生物
石决明	植物
免疫系统	自然
休斯敦	火箭
血余炭	中医药
不拘一格	成语
凤尾竹	自然
鹿鞭	中药
麝香	科学
四战之地	诗词
诗中有画	文化
田力普	简历
矮子看戏	词汇
南诏国	云南
师直为壮	诗词
打工	劳动
文金	生物学
希腊语	朝鲜语
反射弧	生物学
太平道	文化
手足无措	成语
加德满都	名胜古迹
事在人为	文学
手足胼胝	文化
借记卡	社会科学
神州陆沉	文化
希罗多德	人物
交椅	生活
安息香	成语
北京大学附属中学	社会
蓟州	历史
母狼	文明
商标	机械工程
成宥利	人物
东台	历史
侯景	南北朝
牡荆叶	中药
闰秒	时间
跳高	体育赛事
一字千金	成语
年夜饭	新年
使智使勇	典故
生众食寡	典故
玉凤	居家
膀胱炎	健康
十载寒窗	词语
五莲山	旅游
蒲	汉字
死谷	地理
古崖居	文化
山陬海噬	词语
锿	元素
格子	经济
北九水	导游
梦溪笔谈	名著
钍	自然科学
曲霉菌	自然科学
谷物	威士忌
刘智泰	明星
杨致远	名人
葡萄干	自然
高鹗	人物
中华人民共和国水利部	国家机关
锝	元素
锝	化学元素
败材伤锦	语文
比丘尼	宗教
僧	宗教
林韦君	艺术
钵	宗教
蒲团	佛教
动摩擦	机械工程
钒	生物
滑动摩擦	机械
炮兵	军事
菠萝	美食
从事	汉语
轩辕庙	旅游
中空玻璃	科学
云雾茶	江苏
房	语言
继电器	科学
继电器	电子
遗传基因	内科学
阿拉伯海	自然地理
藤野先生	课文
灰喜鹊	动物学
灰喜鹊	自然
昆虫记	昆虫
柠檬草	植物
南和县	地理
水鹿	动画片
奥斯卡金像奖	娱乐
形式主义	社会
避孕	科学
抱朴子	书籍
沙棘	水果
羊水	应用科学
榨菜	十字花科
补骨脂	药品
清史稿	史书
鸡仔饼	饮食
象鼻虫	科学
烟草	香烟
李林甫	人物
决定论	相对论
登喜路	皮带
上传	技术
世袭	制度
熊掌	野生动物
校园文化	校园
藏红花	花
北汉	文化
回光返照	成语
兴奋剂	自然科学
丫	汉字
温度计	物理学
方丹	球员
爹	字典
紫云英	豆目
塔	电力
模拟器	电子技术
琼花	自然
琼花	植物
环境监测	地质学
观星台	地理
纪限仪	地理
幼儿教育	教育
iriver	品牌
鸭嘴龙	自然
巨石阵	文化
川木香	菊科
巴戟天	中草药
下弦月	自然科学
夏完淳	上海
谢榛	明朝
拓扑学	物理学
白蔹	中药
胡狼	哺乳类
香荚兰	兰科
墨兰	植物
白熊	人物
斑海豹	海洋学
大连经济技术开发区	地理
图形	术语
彭司勋	医学家
黄鹤翔	艺人
纤维素	营养学
二十五史	历史
胡春华	河北
宁都县	地理
红霉素	内科学
九宫	哲学
且	逻辑学
名人效应	理论
计算器	船舶
留学	社会
英布	历史
皇太子	历史
白全福	表演艺术家
暖锋	自然
血清	生物学
都梁	编剧
都梁	著名作家
运载火箭	航空
英镑	金融
班门弄斧	成语
八面威风	词语
时标	地理
礼记	文学
华安县	福建
万芳	人物
小脑	人体
小脑	神经科
张道陵	社会
双流县	地理
黄纪莹	艺人
海豹	哺乳动物
脑震荡	死亡
秦燕	电影明星
广韵	音韵学
血浆	药理学
首乌	药品
盛中国	小提琴家
盛中国	艺术大师
地光	自然现象
地垒	环境工程
贾振红	博导
进深	家具
开间	居家
户型	生活
吴启华	娱乐
建筑面积	居家
年逾古稀	词汇
du	考试
郑艳丽	人物
扦插	药品
华士飞	新疆
鳢	鱼纲
体位	医学
肖劲光	海军
猪蹄	特色美食
储集层	科学
五一国际劳动节	劳动
北京第二外国语学院	教育
陈先瑞	军事家
腐乳	烹饪
范朝利	人物
甘渭汉	人物
笨鸟先飞	词语
饱暖思淫欲	汉语
寸草春晖	文化
瑞金	历史
貂熊	生物学
三文鱼	动物
电视卡	电视
貉	生物学
梁必业	中将
何润东	歌手
发蒙振落	人物
负隅顽抗	文化
廖汉生	革命家
豇豆	农作物
合浦珠还	词汇
豌豆	豆科
云实	豆科
刘西元	中将
桑螵蛸	自然
桑螵蛸	植物
论功行赏	语言
狼子野心	词汇
激波	电力
牛鼎烹鸡	语文
赋	中国
孙廷铨	宰相
湖南农业大学	教育
西单剧场	剧场
饶子健	军事
概念	语言学
千人所指	词汇
成本	会计
唐天际	中国人民解放军
如火如荼	汉语
跳鼠	生物
崔颢	诗歌
水滴石穿	词语
吴法宪	书法家
吴富善	战争
老油条	俗语
王梓坤	科学
宋体	书法
徐深吉	军事
记者	律师
贺贤土	科学家
宝洪茶	绿茶
结巴	疾病
投机倒把	市场
周彪	八路军
洛色林	神学家
周贯五	军事
铁罗汉	乌龙茶
铁罗汉	茶叶
严济慈	放射性
陈述句	语言学
课田制	税务
5201314	生活
坐卧不安	文化
水调歌头	诗词
nutch	搜索引擎
按甲寝兵	成语词典
作金石声	文化
贺雨	诗歌
左辅右弼	词语
左辅右弼	俗语
人口普查	社会
注册商标	广告法
罪加一等	语文
青稞酒	名酒
罪恶昭彰	成语
蛇纹	观赏鱼
钻皮出羽	词典
北北	网络
北北	小说家
大豆油	饮食
赛扬	处理器
以貌取人	典故
游手好闲	文化
红钻石	热带鱼
入梅	农历
赛里木湖	水
右玉县	地名
右玉县	山西
友邻	宣传
土力学	地球科学
巴耳末	物理学家
效率	物理
效率	科学
最大公约数	自然科学
浯屿	岛屿
朱木炎	运动
屯	汉语
宿舍	住宿
烤肉	食谱
白平衡	相机
西奈半岛	埃及
西奈半岛	自然
夏侠	人物
尽心尽力	成语
望尘莫及	成语
望尘莫及	文化
咪表	交通
阁下	人文
滑脉	诊断学
滑脉	应用科学
相对性状	物理化学
simulradio	广播
simulradio	技术
神谷明	人物
变形虫	生物学
三清	历史
顾太清	红学
老手	词语
弹弓	怀旧
脑干	科学
月晕	天文
中国银联	组织
亚述	历史
吕荧	文学家
孝感	旅游
中文	语言
张景惠	甲午战争
新洲区	武汉市
工程学	自然科学
eba	游戏
失之交臂	语言
包装	分子生物学
素隐行怪	文学
滑石粉	工业
黄宗羲	历史
鞍前马后	成语
按兵不动	词汇
基带	通信
死有余辜	俗语
朔望月	地理
傲然屹立	成语
林志颖	台湾人
椿皮	植物药
轻工业	技术
八面玲珑	成语
清华大学出版社	经济
舒同	人物
法律出版社	经济
科学出版社	中国科学院
钟水饺	水饺
红丹	颜料
焰口	佛教
艾捷克	艺术
vivo	电子产品
晏子春秋	诸子百家
崇明县	崇明
散尾葵	热带植物
散尾葵	居家
鸟巢蕨	自然
南朝齐	南齐
南梁	南北朝
南陈	历史
廖学秋	人物
李光羲	歌唱家
永暑礁	岛屿
美济礁	地理
道潜	北宋
景宏岛	岛屿
语汇	文化
走马赴任	汉语
纵横交错	典故
自圆其说	成语
纳米比亚	非洲联盟
西道堂	伊斯兰教
女儿节	情人节
章士钊	教育家
车船	船舶
乌原鲤	鱼纲
周光召	人物
郭永怀	教授
宗泽	民族英雄
方以智	科学
水雉	鸟纲
松鼠鱼	菜谱
祁东县	地名
人胎素	健康
人胎素	科学
郭家明	新闻人物
伊朗高原	地理
急急如律令	文化
施蒂纳	人物
冯子材	社会
灯心草	植物学
南瓜子	健康
第六日	大片
娑罗子	中草药
娑罗子	医疗
汪东兴	人物
刘南奎	人物
陇剧	艺术
白扁豆	中药
是	姓氏
晶体	化学
泸定桥	建筑
圆规	数学
日本海	地形
糖衣炮弹	文化
王麓水	英雄
惜花	文学
龙树	社会
闲游	文化
车耀先	烈士
丙酮	生物学
乌苏里江	自然资源
图们江	自然科学
止谈风月	词语
钱江摩托	金融
开幕词	人文
开幕词	文体
磁带	生活
李玮锋	足球
浴佛节	宗教
郭晶晶	水上运动
关门山	旅游
黄健翔	人物
番红花	花卉
科恩乐队	音乐
webshell	互联网
钟楚红	影视
谷雄一	革命烈士
非洲菊	自然科学
路不拾遗	语言
张何明	名人
饭岛爱	明星
高二适	作者
垂体	生物医学
钺	文化遗产
张奂	人物
红眼病	卫生
中	穴位
珲春	吉林
金佛山	重庆
行动	文学
挨家挨户	词语
桑弘羊	历史
晕动病	科学
痴呆	生物化学
张参林	人物
宋庠	人物
王一川	专家
铂金	科学
水牛	自然
心意六合拳	武术
太子河	流域
吃水	海洋工程
李牧童	文学家
党继新	共产党
柞蚕	自然科学
果断	社会
仙王座	天文
球菌	分子生物学
永年县	邯郸
东京大学	中国工程院
网络战	社会
柳直荀	中共党史
秦艽	物种
硝酸铵	物理化学
邓萍	中共党史
国情咨文	文件
胡仁宇	物理学家
何孟雄	人物
董酒	品牌
竹黄	药学
亚得里亚海	海洋
金田起义	历史
金灯藤	生物学
赭衣塞路	诗词
马占山	历史
马占山	满族
膏蟹	烹饪
戴安澜	革命烈士
克里米亚半岛	俄罗斯
局域网	通信
庄希泉	地理
中国共产党第一次全国代表大会	社会
刘黑仔	历史
二话不说	文化
党项族	历史
例行公事	词汇
天门冬	百合科
关向应	辽宁人
井水不犯河水	成语
种族歧视	南非
磁通量	石油工业
磁通量	电磁学
磁滞	磁学
磁滞回线	电工学
介电常数	化学
田园城市	英国
中国娃娃	卡通人物
字符串	计算机技术
石老人	青岛
倒	生活
麻醉学	科学
中医学	国学
食物中毒	食品安全
崔生	人物
斯德哥尔摩大学	地理
陈德权	人物
交流电	应用科学
中华全国体育总会	体育
韦孝宽	人物
临海	浙江
亚平宁半岛	地中海
邹城	山东
神策军	职业
柴绍	隋朝
唐俭	历史
左芬	诗人
泸州	地理
走镖	江湖
沂源县	七夕节
于明信	教育家
于道泉	世界语
牛溲马勃	成语
徐轶千	人物
甘泗淇	湖南
安魂定魄	汉语
阶梯	自然科学
安堵乐业	熟语
赵忠贤	院士
王赣	人物
张灵甫	中国国民党
鞍马之劳	汉语
于守真	淄博
傲慢无礼	成语
清真寺	伊斯兰教
网络相册	技术
记者节	媒体
阿平绝倒	文学
泰雅族	社会
爱人利物	语文
赛夏族	台湾
矮人观场	汉语
安忍无亲	熟语
黯然无色	成语
黯然无色	汉语
行为科学	经济
吏部	社会
万宝路	美国
万宝路	经济
司士	古代
暗室亏心	成语
司农寺	社会
昂首伸眉	汉语
椰枣	树木
集中控制	自然科学
实验	检验
台省	职业
协调	管理
行人	词语
玉座屏	国宝
昂头阔步	词语
不学无术	词语
昂头挺胸	成语
巡按	古代
黄岐山	景点
八思巴	学者
白玉蝉	考古
利令智昏	文化
装订机	办公设备
蕲春县	湖北
陆贾	西汉
戴安邦	化学家
干名犯义	文化
波斯菊	菊科
本科	大学生
理解	简介
蛇目菊	花卉
天卫五	宇宙
盎盂相击	文化
碍足碍手	汉语
爱之欲其生	熟语
饶宗颐	国学
黑川纪章	越南
朱一贵	历史名人
小米辣	藏药
姜亮夫	人物
白切鸡	饮食
朱缨花	花
贵港	地域
不安于位	熟语
晒图机	计算机技术
岑麒祥	河南
百不当一	汉语
青屿汛	名胜
韩超然	古代
纳爱斯	经济
黎锦熙	教授
李方桂	学者
刘又辛	国学
宰执	职称
武训祠	农民
s	数码
不修边幅	词典
罗福颐	文学
哈里森	美国
徐天新	人物
庆大霉素	生物化学
万国鼎	学者
唐文治	学者
摄影棚	广告
河灯	风俗
近景	词汇
地动仪	地震
预约	术语
八一建军节	军人
滨海路	交通
章学诚	绍兴
压肩迭背	语言
牙牙学语	典故
哑口无言	词汇
宁蒗彝族自治县	自治县
雅人深致	典故
烟波浩渺	文化
盖菜	菜谱
田横镇	中国
盖帽	运动
盖帽	排球
兄弟阋墙	成语
兄弟阋墙	词汇
充栋汗牛	成语词典
克伐怨欲	成语
免怀之岁	熟语
免怀之岁	文化
标准大气	气象学
陪审制度	法学
王照	国学
市场竞争	经济学
游禽	词语
南开大学泰达学院	学院
城域网	应用科学
城域网	电子科技
民族共同语	语言文字
执政党	政治
邵圣懿	人物
竹刻	民间艺术
国际禁毒日	节日
道德风险	金融
近日点	流星雨
英山县	地理
续汉书	历史
别构效应	生物
雷管	科学
做张做势	文化
尊主泽民	语言学
振振有词	语言
张謇	博物学家
杜邦	商标
正直无邪	成语
侜张为幻	文学
噪声污染	经济
寡核苷酸	生物学
潮解	分子生物学
总总林林	语言
刘义庆	小说家
冢中枯骨	语言
字斟句酌	词汇
正正经经	成语
心学	王守仁
折足覆餗	词语
没有	语言
控制论	信息
腐殖质	农业
腐殖质	自然科学
鳌园	中国
甲状旁腺	生物化学
秘书节	节日
稀释热	科学
雪佛龙	市场营销
辣根	植物
酒令	游戏
窝窝头	饮食
李季兰	才女
芬迪	生活
关兴	蜀汉
执行力	管理
范钦	宁波
胆道	科学
王二小	人物
尾生抱柱	成语
打情骂俏	俗语
刁民	汉语
文诚熏	人物
北洋大学	天津大学
抱宝怀珍	熟语
鞭不及腹	熟语
张吉山	导演
抱布贸丝	词汇
兵不厌权	成语
百不一贷	词语
败不旋踵	文化
秉笔直书	成语
半痴不颠	词典
把持不定	文化
不拔之志	成语词典
半筹不纳	文化
理赔	社会
不存不济	成语词典
鞭长不及	成语
不茶不饭	汉语
汇付	金融
不差毫厘	汉语
报验	经济
抽样	自然
拉姆斯菲尔德	美国
宋哲元	山东人
美沙酮	药品
饮食	营养
中外合作	法律
东宁县	黑龙江
胎盘	植物药
贯穿今古	词语
优生学	自然科学
抱恨终天	俗语
蠡园	无锡
海胆	芦笋
中国医学科学院肿瘤医院	应用科学
筚路蓝缕	词语
陈纯甄	人物
故技重演	语言
周嘉玲	人物
贵极人臣	国学
贵极人臣	文化
郁方	地理
保德县	地理
原平	奇观
官轻势微	成语
西兰花	自然
马文昭	细胞学
天静宫	旅游
捷安特	公司
夏侯恩	人物
面神经	神经科
周臣	名人
展览会	法律
时堰镇	中国
海洋能	海洋
六出花	中草药
红掌	草本植物
定影	测绘学
感光材料	测绘学
萨那	首都
视角	药品
对比度	电视
变化不测	语文
白黑不分	成语词典
变化不穷	语文
不怀好意	词语
汉正街	商品
赵无极	书画
兰考县	地理
挥洒自如	文化
着丝粒	科学
入不敷出	文化
转录	物理学
头足纲	生物
闷闷不乐	词典
闷闷不乐	文化
薛石民	名人
分门别类	成语
田园曲	乐理
设身处地	语言
三昧	宗教
钻天杨	自然
触景生情	典故
火成岩	地球科学
杜姆卡	乐理
统觉	科学
樟脑	科学
樟脑	香水
皮特凯恩群岛	地理
松江区	地理
祸在旦夕	文化
操之过急	歇后语
呼之欲出	成语
维妙维肖	成语
李思博	写手
月见草	药用植物
三足乌	历史
三足乌	神话传说
冬不拉	艺术
弗拉明戈	地理
联合国开发计划署	技术
定陶县	山东
热胀	疾病
郑民川	名人
封建	文化
仙草	唇形科
沈倍奋	院士
沈家祥	人物
毛华锋	迪迦
剖腹藏珠	文化
韧皮部	植物学
假设	物理学
妹	字典
哥	社会
睚眦	文化遗产
倒装句	语法
麦角胺	国家标准
纽瓦克	美国
纽瓦克	地理
庄士敦	历史
凸轮	科学
森本薰	人物
放大镜	科学
泥炭	自然
秀山	重庆市
桑耶寺	山南
马槟榔	药用植物
直翅目	昆虫学
异端	国学
奥塞博物馆	地理
张太雷	人物
韦拔群	人物
同桌	学生
切腹	武士
鸡肠狗肚	成语
见风使舵	俗语
见机行事	成语
就地取材	文化
见缝插针	成语
浮想联翩	成语词典
胡连会	人物
经久不息	语言
见利忘义	语言
布鲁日	俱乐部
笊篱	厨艺
诗艺	世界名著
丰草长林	语言
王思彤	人物
刘耕宏	音乐
马尔代夫	地名
贼去关门	成语词典
mcfly	punk
胃酸	人体
金瓯无缺	典故
金瓯无缺	词语
周苑	人物
安全气囊	安全
正黄旗	政治
染蓝涅皂	语言
日程月课	语文
下	文字
尼赫鲁	历史
失之东隅	文化
于鑫	学者
及笄	习俗
兰石草	中药
冰河时期	自然科学
阿罕白	中国
个人崇拜	社会
布帛	服装
迪士尼	社会
燥湿	科学
达西	水力学
玉圭金臬	词汇
掩骼埋胔	词典
喷泉	艺术
澳门半岛	澳门
玉关人老	成语
ustc	大学
参比电极	分析化学
胶带	科学
酒醉饭饱	词汇
急竹繁丝	成语
戟指嚼舌	典故
绝子绝孙	典故
拒之门外	文化
积重难反	词语
积重难反	文化
井中求火	词汇
避害就利	语言
眼肌	应用科学
眼肌	眼睛
眼肌	科学
变化如神	词语
变幻无常	汉语
背惠食言	成语
百花生日	熟语
傍花随柳	词语
浆细胞	免疫学
不禁不由	熟语
八九不离十	文化
不紧不慢	词语
农乐舞	体育
比肩而立	汉语
冰解的破	文化
比肩叠迹	汉语
秉节持重	成语
比肩接迹	文化
弊绝风清	文化
总角	语言
黄发	称呼
日产	交通
酚酞	医学
姨	语言
前进	穴位
童陆生	中国共产党
中国石油化工集团公司	金融
国防建设	电子技术
性别比	胚胎
性别比	试管婴儿
鲁智深	一百单八将
洛美	地理
朱衣点头	成语
蝇粪点玉	文化
胸无点墨	熟语
巩金瓯	国歌
影视广告	影视制作
严复	翻译家
伊达氏	历史
龙滩水电站	旱灾
龙滩水电站	洪涝灾害
琼州海峡	地理
古晋	地名
藏莲寺	景点
里湖镇	潮汕
华普	交通
中岛阳子	动画
适应性	自然
绫波丽	牧师
江户	明治维新
东京都	日本
盖棺定论	语言
大凌河	辽宁
面首	历史
电子学	电子技术
花朝节	民族
花朝节	习俗
陆汝钤	人物
陆启铿	自然科学家
黄汲清	人物
吞咽困难	科学
薏苡	禾本科
紫胶虫	自然
伏格乐	人物
杨叶甲	昆虫
上宅文化陈列馆	文化
信誓旦旦	词汇
信誓旦旦	典故
硝酸钾	科学
鲁镇	绍兴
乌烟瘴气	词语
谏院	官署
刘长乐	人物
阎学通	人物
星罗棋布	成语
湘桂线	交通
应接不暇	成语
赵东寰	革命家
南京审计学院	学校
羽扇纶巾	成语
囊萤照读	词语
不觉技痒	词语
圣淘沙	岛屿
比肩连袂	词语
王新亭	军事家
安倍晋三	日本政府
白帢青衫	文化
虎豹别墅	地理
饱经世变	熟语
比肩系踵	熟语
保境息民	词语
彼竭我盈	成语
不愧不作	成语
龙行虎步	文化
闭境自守	汉语
马钱子	兴奋剂
剥极则复	汉语
不及之法	汉语
恨	字典
冰解云散	语言
辩口利舌	汉语
鲁班	伟人
鲁班	山东人
妙峰山	景点
不可奈何	文化
播穅眯目	汉语
元秋	娱乐
天秀尼	人物
罗家英	明星
朝令夕改	语言
妇孺皆知	词语
孟广禄	明星
李显龙	相声
阿党比周	成语
渭城区	咸阳
黄祖耀	亿万富豪
肼	自然科学
shel	艺术
尹式	河间
强度	科学
目不识丁	成语
自贡	旅游
飞蛇	蛇类
大步流星	文学
髌骨	科学
鲍春来	体育人物
靖边县	黄河
德谟克里特	人物
瀛湖	人工湖
香港	中国
香港	历史
香港	工业
心怀叵测	汉语
白釉	收藏
心慌撩乱	成语词典
心慌意乱	成语
心灰意败	语言
动能	物理
心焦如火	语文
心开目明	熟语
心满意得	汉语
心满意得	语言
心慕手追	词典
绝世超伦	字典
石三友	人物
巴旦木	果树
白雪难和	成语
心虔志诚	汉语
斜颈	医学
心如悬旌	汉语
心事重重	词典
短兵相接	语言
心手相忘	词典
心手相应	语言
鸽子花	音乐
弓调马服	成语
钩章棘句	成语
茧丝牛毛	成语
侯霸	人物
心有余悸	语言
中国天主教爱国会	天主教
姜黄	姜目
中华全国台湾同胞联谊会	政治
竹沥	药材
麻生太郎	日本首相
心直口快	成语
心中无数	语言
夏天无	医学
西田乡	乡镇
萧统	人物
纬线	地球
樊学文	军事家
贺吉祥	将军
东半球	科学
温带	自然现象
等高线	测绘
单边	人文
气温	环境
斯毕德	车手
正则表达式	科学
德累斯顿	文化遗产
欧洲中央银行	葡萄牙
秦德公	秦朝
汉诺	探险家
汉诺	人物
五四运动	文化
甘祖昌	军事家
孔德萍	人物
奏折	清代
组合音响	家电
万振西	人物
黄堇	被子植物
白芨	中药
雁来红	国花
自由泳	游泳
竺法兰	人物
余勇可贾	语言
五服	生活
食蚊鱼	自然科学
遗黎故老	文化
遗寝载怀	文化
遗声余价	成语
阳元石	地理
刘腾	北魏
跑龙套	成语
斯芬克斯	时尚
霸权	文化
长期投资	金融
华为技术有限公司	数码产品
阿尔及利亚	阿拉伯国家联盟
颐神养气	词典
上好下甚	历史
步辇图	文物
颐养精神	文学
颐养天年	熟语
颐指风使	词典
尚达奉	人物
疑事无功	词汇
疑行无成	汉语
表里山河	语言
西方	文化
以紫乱朱	成语
以锥刺地	汉语
以珠弹雀	汉语
安士白	神话
韦卓民	人物
诚惶诚恐	词汇
基准利率	银行
章草	字体
蔓草	装饰
阿拉伯	种族
珍珠岩	自然科学
以义割恩	语言
以义断恩	汉语
光卤石	煤矿
以疑决疑	语言
生抽	饮食
递归	科学
卞德培	天体
卞德培	自然科学
以一儆百	文化
袁翰青	人物
袁翰青	书籍
坎坷	汉语
头孢西丁	药理学
数学方法	数学
香辣蟹	饮食
孔令奇	港台明星
以血洗血	文化
以刑止刑	词语
以心问心	成语
以文乱法	汉语
张梓桢	军事家
持票人	财务会计
夏目漱石	小说家
廖鼎祥	少将
薄荷脑	植物药
以汤沃沸	汉语
杜锡瑞	书法家
陈李济	药店
氯气	自然科学
不堪入耳	文化
不堪其忧	熟语
以水洗血	成语
沙枣	植物学
喜满你	互联网
不可逾越	熟语
宾客盈门	汉语
不可胜言	汉语
不劳而成	成语
不冷不热	文化
不冷不热	汉语
温体仁	大臣
程天民	院士
葛宝丰	院士
沿江路	温州
傀儡政权	苏联
以人为镜	熟语
象征主义	法国
以权达变	词语
勒拿河	水业
勒拿河	自然科学
以强胜弱	熟语
丁武选	军事家
曾仕强	哲学家
马冠三	军事家
以简驭繁	熟语
以火止沸	汉语
以火去蛾	熟语
千字文	历史
蔡桥镇	乡镇
机变如神	词语
饥馑荐臻	熟语
饥饱劳役	成语
鲯鳅	钓鱼
交尾	昆虫学
项怀诚	山东大学
邵循正	人物
王禄江	港台明星
娈童	犯罪
公孙杵臼	山西
黄世仲	人物
梁培基	人物
潘达微	人物
自由港	商业
自然选择	理论
自感系数	物理学
子弟书	书籍
冰草	中药
徐国贤	少将
农学	农业
农学	农作物
鹅口疮	生活
象齿焚身	语言
王正廷	运动员
数控机械	机械
曹髦	三国
画蚓涂鸦	成语
话里有话	成语
怀璧其罪	文化
肖应棠	将军
胡因梦	台中
气冲牛斗	成语词典
谦恭下士	成语
损上益下	成语
升堂入室	文化
年高望重	文化
年高望重	语言
一无长物	文化
巴三览四	词语
丁一确二	成语故事
径一周三	成语
三言两句	成语词典
三言两语	成语
平房区	哈尔滨
金印紫绶	国学
托运单	物流
开源节流	词汇
两脚书橱	文化
下流	文学
贵庚	词语
瑜不掩瑕	国学
琼岛春云	成语
琼岛春云	典故
东床坦腹	词语
谢文锦	永嘉
狂奴故态	典故
郑义斋	近代史
张克侠	河北人
册封	历史
胡玉芳	人物
外白渡桥	旅游
征名责实	成语
狰狞面目	语言
变轨	科学技术
季步高	烈士
正法直度	成语
正冠李下	文字
正冠纳履	语言
正色敢言	词语
正色危言	汉语
罗光燮	历史
王根英	历史
飞行服	飞行员
正心诚意	词语
刘诗昆	明星
李嗣源	历史
驱动之家	技术
谷类	自然科学
戈雷岛	地理
灰黄霉素	生物化学
殓	死亡
卡勒瓦拉	诗歌
美洛西林	应用科学
萘啶酸	药理学
诺氟沙星	抗生素
氧氟沙星	医学
山治	动画
皮皮岛	生活
清莱	泰国
王丹凤	娱乐
烤羊肉	烹饪
农一师	兵团
沙琪玛	美食
波罗塞戏	熟语
跋履山川	成语
不吝指教	语言
表里相依	语言
半路修行	汉语
厄尔布鲁士山	山峰
博览五车	语言
八面受敌	砚
八面受敌	语言
拔毛连茹	成语
闭门酣歌	词语
研究所	历史
病魔缠身	文化
背盟败约	成语
半面不忘	汉语
宝马香车	熟语
1888年	年份
1858年	年份
气候系统	科学
郑人争年	成语
郑卫之音	文化
支床叠屋	汉语
枝对叶比	汉语
枝附影从	熟语
枝附影从	文化
知来藏往	词汇
乌木	居家
知人论世	词语
知人论世	文化
知往鉴今	成语
知我罪我	词语
北京大学医学部	大学
无厘头	人物
无厘头	王菲
胸肌	人体
毛里塔尼亚	地理
sras	传染病
舍本求末	词汇
百年不遇	成语
一步登天	韩剧
擦音	社会科学
王若飞	革命烈士
荷花淀派	文学
音速	物理现象
默默无闻	词语
乞哀告怜	语言
乞浆得酒	语言
千了百当	成语
谭友林	军事家
单元测试	科学
鞭擗进里	文化
不偏不党	语言
阳强	药方
百年谐老	语言
百年之柄	词语
不宁唯是	成语
深文周纳	词汇
杨端六	国民党
楚才晋用	文化
秋风过耳	典故
尺二秀才	成语
背前面后	词语
惨澹经营	语言
辞多受少	文化
愁长殢酒	语言
晨炊星饭	成语
萨尔图区	区县
赵虹乔	港台明星
税率	经济法
附加税	财务会计
蔡长元	将军
兵强将勇	汉语
陈宜贵	军事家
鲁西牛	畜牧
析疑匡谬	成语词典
呃逆	卫生保健
才高七步	语文
击钵催诗	国学
儿童期	生活
毕节	地理
结党营私	成语
傅家选	将军
矜	汉字
郭芯其	女艺人
姐妹节	传统
抚远县	中国
藏狐	哺乳纲
小野洋子	人物
棍	词语
曾呈奎	学者
丰田汽车公司	金融公司
病毒唑	分子生物学
金刚胺	医药
太初历	太阳系
氨硫脲	科学
尤先科	人物
不屑一顾	文化
松田阵平	动漫
吴浩康	人物
吴秀波	人物
断裂力学	物理学
广州体育学院	教育
中国农工民主党	社会
台湾民主自治同盟	中国
四时八节	词汇
五黄六月	气候
罗愿	诗人
陪审团	美国
自成一格	文化
乐座	商业
尺子	发明
自坏长城	成语
自觉形秽	词语
娄圭	三国
自求多福	熟语
诺查丹玛斯	法国
诺查丹玛斯	预言
自取其祸	文字
自始自终	文字
海不波溢	词汇
自用则小	熟语
水解反应	分子生物学
胆汁质	心理学
武道馆	日本
监察院	政治
中央研究院	台湾
望安岛	地名
反复无常	典故
气冲斗牛	文化
浊水溪	地理
装载机	航海
转子	自然科学
金史	文学
损害赔偿	法医学
法兰面	建筑
拶	汉语
梁冠华	明星
慧	佛教
马里亚纳群岛	地理
三合会	文化
中道	佛教
水芹	药品
卡尔纳普	哲学
高丽藏	佛教
此起彼伏	词汇
杨贤江	浙江人
匡亚明	教育
卡雷尔	人物
太空站	航空
太空站	航天器
长春经济技术开发区	长春
谓语	社会科学
百巧千穷	成语
并驱争先	汉语
卡诺循环	物理学
青葙	苋科
哈钦松	植物学家
背曲腰躬	成语
教无常师	语言
卡斯特里	城市
df	手表
巴前算后	语言
动能定理	力学
武冈	地理
主席	科学家
黄麻	植物
勃然奋励	文化
姜声扬	港台明星
并日而食	语言
回心转意	文化
周瑛琦	港台明星
卡亚俄	秘鲁
鲁国	孔子
一之谓甚	语文
一日三省	成语
三平二满	文化
白日衣绣	熟语
开罗会议	历史
蒋燕皎	解放军
傍人篱壁	成语
白日见鬼	成语
五一国际劳动节	节日
半上半下	汉语
半死半生	成语
半死半生	熟语
半身不遂	文化
不生不灭	成语
金榜	词语
腊八节	饮食
事以密成	俗语
朱思本	诗人
文化史	文化
文化史	文学
老调重弹	文化
另起炉灶	政策
郑国渠	古代史
沸沸扬扬	成语
dbf	windows
置身事外	语言
中国美术家协会	美术
基因簇	分子生物学
锦州师范高等专科学校	技术
鸿毛泰山	词汇
郑周永	现代
中国舞蹈家协会	艺术
chn	中国
都乐岩	景点
推重比	飞机
纪连海	学者
哀牢山	云南
李钟郁	政治
九鲤湖	景点
贝子庙	景点
波普尔	哲学家
迎宾馆	地理
巨峰	葡萄
匕首	军事
萨乌丁	体育
朝斯夕斯	语言
环磷酰胺	自然科学
王圻	名人
青霉素	药学
草创未就	词典
开水	矿泉水
昌歜羊枣	文化
吞噬细胞	免疫学
克分子	理论物理
榱栋崩折	词典
尺短寸长	词典
尺短寸长	语言
潜蛟困凤	俗语
暗河	地理
法典	宗教
背包族	旅游
场频	科学
如虎添翼	文化
奥金莱克	人物
易子而食	文字
封闭系统	热力学
谷饶镇	广东
南澳县	中国
无党派人士	政治
材料	机械工程
唯实论	社会科学
陕北	黄土高原
台湾电视公司	媒体
谢冰莹	文学
珠算	数学史
联合国儿童基金会	奥斯卡
踩	汉语
康帕内拉	哲学家
投机者	人文科学
宣化承流	词语
肥城	地理
轩然霞举	语言
颠倒	社会
随喜	术语
经行	汉语
威仪	术语
比利时	奥运会
丙磺舒	医学
杯葛	贸易
碳酸锂	内科学
圈子	行政区划
安期生	人物
杯蛇幻影	文化
避世金马	汉语
博硕肥腯	汉语
博识多通	词语
不识大体	语言
贾探春	人物
社稷	古汉语
长者	佛教
并行不悖	语言
彪形大汉	文化
口袋妖怪	任天堂
巴三揽四	汉语
百世流芬	文化
曹可凡	晚会
白手空拳	语言
不食马肝	语言
卑身屈体	文化
脑膜炎	科学
科斯托夫	人物
白首穷经	词语
白首穷经	文字
霍峻	人物
科学管理	经济
不失黍絫	词语
北叟失马	成语
白首相知	文化
囚首垢面	语文
因材施教	成语
围城打援	成语
席不暇暖	文化
王伯成	文学
宇文虚中	中国
张国宾	人物
室怒市色	语言
维生素	物理化学
顽父嚚母	汉语
卢宁军	运动员
在所难免	文化
穷凶极恶	文化
情见乎辞	词典
结不解缘	文学
结绳而治	文学
克里斯托夫	记者
群威群胆	语文
戒备森严	成语词典
奇文共赏	成语词典
和记黄埔有限公司	生活
借书留真	典故
去泰去甚	词典
今愁古恨	成语
秋荼密网	词典
石介	文学家
石孝友	文学家
金貂换酒	文学
寝苫枕块	历史
民富国强	成语词典
青史垂名	成语
民生凋敝	词典
唐骏	商业
克洛维	人物
秋扇见捐	词典
慈宁宫	紫禁城
慈宁宫	艺术
杜立特	人物
脂类	自然科学
趋光性	动物
吴融	人物
施耐庵	著名作家
卑鄙	汉语
朝穿暮塞	成语
朝穿暮塞	词语
灌南县	地理
许仲琳	人物
择善而从	文化
魏似韩	历史
沁人心脾	文化
契若金兰	文化
广播站	科学
轻裘肥马	语文
冷嘲热讽	文化
三氧化硫	化学
朝令暮改	词典
配合	高新技术
在所不辞	语言
遭家不造	汉语
崭露头角	文化
朝华夕秀	词汇
朝升暮合	汉语
赞不绝口	语言
贼头贼脑	文化
杂七杂八	文化
修身洁行	词典
膨胀系数	地质
折槁振落	汉语
修旧起废	成语
峰会	流行语
pcie	主板
皮革	词语
皮尔士	哲学
休兵罢战	词语
冢	汉字
文字学	文学
恭默守静	词汇
躬耕乐道	熟语
躬冒矢石	成语词典
躬自菲薄	汉语
漫天蔽野	词语
漫天遍地	汉语
争猫丢牛	汉语
彰善瘅恶	成语
招降纳叛	词典
牡蛎	生物
招权纳贿	词典
折冲尊俎	文化
折冲尊俎	语言
周立三	地理学家
周而复	名人
预备役	政治
汪大渊	航海家
圆周率	数学史
月落星沉	成语
月落星沉	文化
拉斯姆森	体育人物
月落参横	语言
月里嫦娥	成语
董炯	运动员
提交	社会
邓绥	人物
望夫云	神话传说
雀屏中选	语言
轻诺寡信	成语
七零八落	文化
齐家治国	成语词典
倾家荡产	词汇
气急败坏	成语
琪花瑶草	语言
协方差	数理统计
纳仁	美食
纳仁	饮食
上海图书馆	建筑
侯胜茂	台湾
郝龙斌	中国共产党
汤火圣	人物
孙大千	人物
张耳	文言文
沈约	历史
陈宗坤	人物
陈远波	军事家
今视网	网站
新视听	互联网
玩物丧志	词语
光呼吸	生物学
伴食宰相	词语
博通经籍	成语
不世之业	汉语
不舍昼夜	熟语
不舍昼夜	语言
不猧不魀	文化
送子观音	神话
半文不白	熟语
鼻塌嘴歪	文化
帕尔玛	人物
艾丕善	名人
博闻多识	汉语
备位充数	文化
兵无常势	文化
纳格尔	哲学家
斑蝥	中草药
铁线蕨	植物学
控制器	电力
瑛	汉语
瑛	语言
糖蒜	生活
茅盈	西汉
茅盈	社会
南阳盆地	盆地
南诏	云南
糖蒜	健康
斯洛文尼亚	世界贸易组织
清音幽韵	语言
水笔仔	自然
魏了翁	学者
钟乳石	矿物
引商刻羽	文化
叶清臣	宋词
泡辣椒	饮食
罗兰夫人	历史
宽甸满族自治县	丹东市
矿石	科学
催熟	农业
白兆山	旅游
大三通	台湾
大三通	交通
参赞	国际
曹景宗	官吏
耻与哙伍	典故
吩噻嗪	化学
意在言外	文学
慷慨悲歌	文化
布赫	人物
象耕鸟耘	语言
贡禹弹冠	成语
定音鼓	艺术
蓝曼龙	动物
尚塞	画家
红雪茶	生活
埃	汉字
矮	字典
北京中加学校	教育
海青	演员
沈殿霞	主持人
余永宁	人物
刘木易	人物
杯中物	诗人
土土	歌手
骨髓瘤	生物医学
闲情逸致	成语
呼吸衰竭	内科
虚词	语文
指空话空	语言
指东画西	词语
伶人	词汇
镖师	文化
大海鲢	古生物
cta	金融
周初明	新加坡人
孔稚圭	文学家
潘尼	历史
文书	文化
龙头企业	经济
赖雅妍	艺人
碍	单词
腤	词汇
鞍	字典
垇	语言
爊	词汇
空间数据	术语
数据共享	信息
惠士奇	人物
当当网	购物
爱沙尼亚	世界
亚美尼亚	欧洲
希腊	东欧
希腊	世界贸易组织
禁运	外交
大名县	河北
刘献廷	历史
产业	经济
产业政策	贸易
普渡众生	典故
宣仁太后	历史
导师	制度
导师	社会
王士祯	山东人
胡经甫	科学家
胡经甫	生物学家
长拳	体育
史坚如	辛亥革命
肠结核	内科学
戈尔季	科学家
钟惠澜	医学家
场效应管	电子
场效应管	自然科学
美景良辰	文化
买贱卖贵	文化
昧己瞒心	词典
买静求安	成语
买静求安	语文
彭实戈	名人
巾帼	文学
巾帼	时尚
欧阳中石	学者
美轮美奂	成语
美轮美奂	语言
沐露梳风	文学
鬼臼毒素	药品
卖身投靠	词典
车里雅宾斯克	苏联
尘肺病	内科学
阳光板	生活
戊二醛	分子生物学
六必居	老字号
攽	汉字
绢本	艺术
豹骨	中草药
鱼鳔	自然
garden	生活
持危扶颠	文化
挺胸凸肚	典故
拾带重还	文化
挑肥拣瘦	国学
挟山超海	文化
一应俱全	典故
面面俱到	成语
四分五裂	成语
一草一木	成语
鸾翔凤集	词汇
一掷乾坤	典故
一点灵犀	成语
迟脉	中医药学
信息流	经济
肺不张	科学
鲁鱼帝虎	国学
鲁卫之政	字典
佑	字典
红螺	生物
红螺	海洋
操奇逐赢	成语词典
铬铁矿	地理
穰穰满家	成语词典
人百其身	成语
人百其身	语言
亓谦斋	将军
发短心长	成语
丁加奴	马来西亚
电流表	电学
电流表	通信
燧石	化学
蝴蝶树	中药
noob	电子竞技
小鸦鹃	自然
谢克家	宋词
林伟宁	体育运动
肥马轻裘	成语
大恩大德	成语
光度	自然科学
昏星	天文学
徐寅生	名人
普里莫拉茨	乒乓球
恭喜	语言
文楚安	学者
种子休眠	农业
袁炜	著名作家
如拾地芥	文化
茹柔吐刚	成语词典
热泪盈眶	成语
如临深渊	语言
波路	自然
海水群飞	词语
寒来暑往	文化
违心之论	成语词典
神学	北美洲
面红耳赤	词汇
体国经野	西周
鬼烂神焦	国学
食宿相兼	词语
餐腥啄腐	词语
风行草偃	文化
风雨不改	典故
铸木镂冰	成语
阪	文化
磅	汉字
chinaren	搜狐
劚	汉语
白铁矿	化学
鴸	神话
鴸	汉字
辉钼矿	自然科学
柳恽	南北朝
德国杯	足球
蒋梦麟	浙江大学
杨姓	姓氏
巴哈马	英联邦
贝塔石	物理化学
体质	生物
基础科学	自然科学
灌夫骂座	典故
牝鸡司晨	典故
崇高	文化
孤掌难鸣	文化
言而无信	文化
拔宅上升	成语
激光器	电子
激光雷达	理论物理
吉伯	自然科学
红花油	外用药
雌蕊	植物
松菌	中草药
轻车熟路	典故
金鸡湖	工业园区
叩阍无路	词典
弥留之际	文学
弥留之际	语言
路断人稀	词语
毛羽零落	语文
靡颜腻理	词典
马仰人翻	汉语
船级社	船舶
serverlet	电脑
极移	科学
一夕一朝	词语
一夕一朝	文化
振振	词语
焙	语言
甭	语言
佊	生僻字
币	语言
闭	语言
庇	文学
磁场强度	电磁学
磁导率	通信
硫矿	化学
硫矿	自然科学
磁化强度	电子技术
邓潜	鸦片战争
哈德成	宗教
哈德成	人物
哈德成	阿訇
武鸣县	地名
海贝格	挪威人
茶树	茶
冯跋	历史
前列腺炎	自然科学
指示剂	定义
因果关系	流行语
清河县	山东
银环蛇	有鳞目
银环蛇	科学
海鞘	自然
直罗镇战役	第二次国内革命战争
执政官	帝国
田秉毅	体育人物
张幼文	人物
铝土矿	地质
森严壁垒	国学
菱形	机械零件
请假条	写作
大鸿寨	地理
没衷一是	语言
泥船渡河	词汇
清蒸鱼	烹饪
推荐	语文
金雀花	植物药
蕉城区	宁德
楼云	人物
天水围	地理
内蒙古北方重型汽车股份有限公司	上市公司
郑逸梅	文学家
藏弓烹狗	词语
苍颜白发	汉语
苍生涂炭	词语
苍黄反复	成语
苍黄反复	汉语
苍黄翻覆	汉语
苍狗白衣	文字
沧浪老人	成语
南澳岛	地理
宝晶宫	地理
咸村	地理
张实杰	将军
气锁	自然科学
注水压差	专业术语
丁本淳	军事家
池峰城	中将
王建青	人物
王道全	社会
退烧药	科学
藏诸名山	汉语
高枕而卧	成语词典
高悬秦镜	语言
铁矿	自然资源
厄瓜多尔	智利
长亭	词语
阴极保护	简单机械
香酥鸡	生活
韩德让	河北人
韩企先	历史
钙钛矿	科学
水镁石	自然科学
水镁石	地球科学
正剧	历史
阵地战	军事
东支西吾	文化
东补西凑	文化
杭子和	名人
锂辉石	珠宝
温柔敦厚	文化
黄疸	医疗
龟甲	自然科学
李玉伟	辽宁人
豪	语言
郝柏村	人物
冷水江	地名
淡竹	禾本科
成武县	山东
和县	芜湖市
行政诉讼法	社会
王熙凤	红楼梦
风中之烛	汉语
风烛之年	文化
抵押	金融
宫车晏驾	词汇
冠冕堂皇	文学
赫拉特	文化
淤积	桥梁
众议成林	词汇
众议成林	词典
印加	帝国
人行天桥	建筑
梁式桥	应用科学
辛文子	文化
景差	人物
左云县	大同
愚昧无知	词语
硇砂	药品
王符	东汉
奥运村	体育
荡	文化
周海婴	摄影家
见微知著	词汇
见义勇为	金融
串话	电话
庞泉沟	地理
河北宣工	经济
侯玉珠	奥运会
庄晓岩	奥运冠军
乐靖宜	体育
肖俊峰	冠军
宿城区	行政
诺贝尔和平奖	古巨基
障碍物	军事
马德钟	tvb
大处着眼	词语
竣工	汉语
张锡纯	医学
顶板	煤矿
底板	建造
郐下无讥	文学
积雪囊萤	文化
张柬之	大臣
苏里南	地理
苏里南	文化
逻辑思维	科学
张季鸾	传媒
密度板	应用科学
液氮	化学
张大煜	化学家
乙烷	科学
隆务寺	建筑物
尚书第	旅游
冷链	科学
下关区	穴位
吉尔吉斯斯坦	不结盟运动
成双成对	语言
栖霞区	地区
乳化剂	化学
防腐剂	健康
防腐剂	林学
喉癌	生活
候风地动仪	自然科学
云烟过眼	文学
乙酸乙酯	化学
石祥祯	人物
胡萨克	人物
胡三省	史学家
中国石油化工集团公司	上市公司
叶县	平顶山
阿糖胞苷	药理学
虎钳	技术
阿达帕林	药理学
水平极化	电子
调相	电子
华夷	历史
栾城县	承德市
截止频率	电子科技
蜗角虚名	文化
握蛇骑虎	文学
香蜜湖	广东
夜郎国	历史
君权	国家
堆金迭玉	文字
彭侯	神话
断无此理	成语
断简遗编	文字
断缣零璧	文化
断缣寸纸	汉语
波恩大学	德国
反渗透	化学
反渗透	海洋学
仁浆义粟	成语词典
影壁	艺术
利率	术语
利率	贸易
康濯	著名作家
泣下如雨	语言
李明灏	人物
陈渠珍	军阀
十步香草	语言
十病九痛	成语
发言盈庭	词典
普遍	社会
大煞风景	语文
大煞风景	文化
程子楷	名人
伏而咶天	语文
杨大易	名人
原封不动	语言
一刀两断	成语
安良发	名人
杨维桢	艺术
平面图	术语
粗度	材料
草甘膦	有机化学
宜阳县	中国
武陟县	地理
得气	应用科学
搪瓷	常用
李师道	人物
朝阳街	景宁
国有化	经济
国有化	经济危机
花色素	自然科学
达鲁花赤	元代
贩夫贩妇	语言
冬烘先生	词典
恫疑虚喝	文学
滑坡	地质学
洞烛其奸	词语
虞城县	地区
泛泛而谈	词汇
斗而铸锥	文化
斗方名士	文字
发奋图强	语言
斗榫合缝	文学
斗榫合缝	典故
豆剖瓜分	成语
反眼不识	汉语
方底圆盖	汉语
独出己见	词典
放马后炮	汉语
耳红面赤	文学
耳闻目击	词汇
画廊	绘画
画法几何	自然科学
蛏子	自然
琤	字典
坏帐	科学
安妮公主	公主
奉头鼠窜	成语
奉为至宝	语言
迪士尼	美国
肤受之诉	成语词典
肤受之言	成语词典
伏龙凤雏	典故
荒漠	高新技术
荒漠气候	地理
机	社会
黄宏嘉	上海大学
丰惠镇	地理
白氏	姓氏
额	流行语
黄量	科学
黄士陵	艺术
辉绿岩	地球科学
刘祁	人物
活化分析	自然科学
刘青藜	人物
百无所成	汉语
塞瓦	名人
秉文经武	语言
仁川镇	地理
霍耳效应	效应
忍术	日本
春谷	食物
建筑学	艺术
马替奴	人物
风采	词汇
提洛岛	希腊
拉法格	历史
沙	文化
投标者	武器
生境	生态学
婵娟	名词
地热资源	科学
一甲胺	化学
迂阔	西部
普者黑	生活
展览馆	建筑学
骨碎补	姜目
伊贝母	中药
綦	百家姓
半官方	语文
格则勒	文化
泽当镇	旅游
龙山岛	地理
秦孝公	战国
楚共王	楚国
郑允浩	韩国
行	说文解字
钻	机械
验电器	自然科学
万人空巷	成语
石竹花	自然
维博	互联网
鱼丸	生活
车杜里	人物
氟磺胺草醚	园艺
结晶	词语
扑草净	农业
廊	结构
萘乙酸	科学
劳动力	人口
库洛牌	占卜
鸳鸯戏水	美食
博士伦	经济
孔席墨突	词典
类脂	分子生物学
亚洲	西亚
独轮车	健身
网易公司	网络游戏
灵隐	宗教
吴兴祚	清朝
太白县	陕西
商都网	技术
李汉俊	人物
李佳白	人物
中国足球协会	体育
兆	物理学
自然村	地理
李旭旦	江苏
李正敏	名人
省辖市	中国
理疗	应用科学
辛德惠	博士
辛德惠	学者
力偶	科学
利贝曼	画家
利比亚人	利比亚
北大西洋公约组织	军事
利库德集团	社会
利兹	世界
前言	第二次世界大战
不修边幅	语言
连续函数	物理学
百无一成	词语
布里斯托尔	旅游
放荡形骸	语言
飞鹰走狗	成语
吠非其主	文化
梁希	社会活动家
崇山峻岭	文字
非我族类	词汇
量子数	化学
垂涎欲滴	语言
耶律隆绪	人物
彭华英	台湾
隐晦曲折	词汇
腰金衣紫	文学
鱼传尺素	文学
韫椟而藏	文学
燕尔新婚	成语
维尔司	体育
赖兴祥	港台明星
列维坦	俄罗斯
风樯阵马	词语
粉妆玉琢	汉语
分形同气	词典
风度翩翩	文化
朱清时	教授
飘萍断梗	词语
东方集团	金融
高原气候	自然现象
李筱峰	文学家
郑天寿	小说
郑天寿	宋朝
飘风骤雨	成语
漂母进饭	语言
胼胝手足	文化
庞眉鹤发	汉语
滂沱大雨	词汇
风雨飘摇	成语
冯唐易老	成语
缝衣浅带	文化
孚尹旁达	典故
扶摇直上	文学
负弩前驱	文化
林威助	人物
约旦人	民族
外挂	网络
氖气	化工
晓得	词语
辛桐	人物
鼻涕	应用科学
nebula	模拟器
河乌科	鸟纲
朱莉叶	导演
朱富	水浒传
格洛纳斯	俄罗斯
鱼游釜中	成语
饫闻厌见	文化
首都博物馆	文化
出奇不穷	成语
薛永	水浒传
蔡福	人物
泣麟悲凤	词汇
厦门电视台	电视台
片甲不回	成语
枯树生华	语言
掩目捕雀	成语
芥蓝	植物
裘弊金尽	典故
临难铸兵	典故
铜驼荆棘	语言
美如冠玉	文学
服务业	词汇
服务业	销售
若存若亡	词汇
人文科学	语文
康奈	历史
酿皮子	生活
醉鸡	特色美食
造端讬始	国学
宋治民	名人
汪洪清	人物
汪运祖	将军
汪少川	名人
余嗣贵	人物
海南粉	特色小吃
添枝接叶	汉语
多模	通信
硝酸钡	自然科学
陈佐湟	人物
碳酸钾	科学
新乐	县级市
血槽	武器
遵化	旅游
圣父	天主教
圣父	基督教
陈伟殷	人物
东南汽车	交通
风险	词汇
全椒县	安徽
四洲志	林则徐
加卡利亚	宠物
利税	金融
火山爆发	自然现象
藏山	山脉
屯溪区	市辖区
李楚源	商界
巷战	军事
隆回县	旅游
太谷饼	饮食
胡咏言	文明
释回增美	文学
氧化铝	电子
巴旦木	生物
维京人	欧洲
孔太	培训师
颜锦福	民进党
杨维哲	台湾
绥阳县	地理
语义学	自然科学
铃木虎雄	文学家
根雕	艺术
东秀村	地理
关王庙	驻马店
星岛湖	地理
吴敦义	人物
刘大杰	学者
刘复之	警察
通山县	地理
王沪宁	上海
乌兰山	旅游
郧西县	十堰
流域	地理
流形	科学
协定	语文
硫醇	分子生物学
瘤	古生物学
榆次区	晋中
渔业资源	环境
忠肝义胆	成语
蒲寿庚	宗教
模板	数理化
脂膏不润	成语词典
葱油鸡	生活
邹衍谷	绝句
桃太郎	日本
千里思	诗词曲赋
六西格玛	计量单位
大气层	自然科学
冷眼旁观	国学
母版	软件
阒无一人	文化
何必当初	词语
舞狮	春节
新仇旧恨	成语
恨铁不成钢	语言
湖屯镇	山东省
桃园镇	地理
邓仲元	革命烈士
刘珉宏	主持人
蒋新松	机器人
珠沉玉碎	文化
咫尺万里	词汇
张敞画眉	文化
轨物范世	国学
追本穷源	成语
几不欲生	语言
昏昏欲睡	语言
极情纵欲	文化
治病救人	国学
欲速不达	成语
欲速不达	语言
欲益反弊	文化
西南农业大学	大学
争锋吃醋	汉语
陈邕	人物
大理白族自治州	中国
傣历	文化遗产
带脉	奇经八脉
营私罔利	成语
鹰心雁爪	词语
鹰鼻鹞眼	成语
鹦鹉学语	语言
信用证	金融
富贵手	医疗
新闻自由	吉尔吉斯斯坦
国电南自	股份公司
衣恋	服装
心门	科学
腾龙阁	楼盘
法威曼	服装
卤代烃	化工
袁保恒	政治家
铁面御史	典故
陆地卫星	农作物
陆元九	科学家
录音	物理
虹膜仪	美容
故城县	地理
余洪元	人物
于阗文	语言
吕纪	人物
攒眉蹙额	语言
绿肥作物	生态学
家给民足	成语
齐宫词	李商隐
罗贡坝	大坝
罗经	科学
王友亮	历史
罗姆	人类
金茂大厦	地标
囿	汉字
马特	神话
张际春	黄埔军校
斋浦尔	印度
着实	汉语
马俊仁	体育明星
宋霭龄	中国
王楠楠	中央音乐学院
兰桂坊	交通
走步	词语
不相闻问	成语
冰消雾散	熟语
跛行千里	词语
标新领异	词语
灵芝茶	食疗
岱海	地形
变心易虑	熟语
伯埙仲篪	成语
鲁南	人物
四棱豆	生物
10	自然数
女低音	歌剧
信息工程	信息
吕利	人物
脐带血	医学
李世石	棋手
梵蒂冈	欧洲
免费搭车	经济
碳酸钙	地球科学
陈横	人物
乌敏岛	旅游
苦荞麦	抗癌
苦荞麦	中草药
抗颜为师	成语
打坐	佛教
石一宸	军事家
吕作松	人物
吕黎平	将军
宣武医院	医疗机构
疾首蹙额	成语
疾不可为	成语
济弱扶倾	词语
数据流	数据结构
不言而信	成语
不言而信	熟语
八音遏密	熟语
舍旧谋新	词语
舍旧谋新	汉语
拨云睹日	文化
驻波	电子
白衣公卿	词语
不言而谕	成语
不由分说	语言
别有风趣	文化
万寿无疆	汉语
杯影蛇弓	成语
穷寇勿追	语言
孝子贤孙	文学
黄南藏族自治州	自治州
饱以老拳	熟语
悖言乱辞	词语
济世救人	文化
热血沸腾	汉语
目无余子	词语
不以为然	汉语
鸡鸣而起	文化
别有心肠	词语
首都医科大学宣武医院	医疗机构
伯玉知非	熟语
回天之力	国学
民营企业	商业
马拉开波	城镇
网师园	园林
马萨乔	油画
大烩菜	饮食
吞云吐雾	成语
毛汉礼	诸暨
毛皮	艺术
梁化龙	人物
李庆芳	山西
叶上花	生物
叶上花	奇闻
邓家泰	名人
双汇集团	社会
贫民窟	社会
李世焱	人物
李良汉	人物
术语	机械
任免	社会
克拉根福	旅游
有生以来	文化
有气无烟	成语
有其父必有其子	成语
金迪亚	地理
楼忠福	经济学家
卢象升	艺术
硝酸银	自然科学
有过之无不及	词汇
有负众望	文化
臭不可闻	成语
远望号	技术
有风有化	语言
有财有势	熟语
鬼压床	巫术
乘肥衣轻	成语词典
晋景公	君主
触机便发	典故
豺狼之吻	文化
天津市青年京剧团	艺术
承前启后	词语
ustb	教育
欺人自欺	汉语
一锤定音	文化
一朝之患	词语
多行不义必自毙	简介
雕章镂句	成语
梁咏琪	音乐
斩仓	期货
洗碗机	技术
王巨洲	名人
豫章	南昌
陈情表	文学
小气鬼	惯用语
法文	科学
2001年	时间段
斯特凡诺普洛斯	希腊
哈斯特尔特	人物
王峻涛	互联网
意丹奴	生活
望门投止	国学
一般见识	文化
广州医学院第一附属医院	应用科学
画栋雕梁	成语
瑚琏之器	语言
画地刻木	词语
盘子	曲种
习与性成	成语
计斗负才	成语
陈江平	科学
榆社县	山西
莫敢谁何	文学
秦王宫	陕西
排斥异己	语言
华屋山丘	语言
壶关县	旅游
横行不法	词语
横行不法	文化
衡阳雁断	熟语
陵川	行政
巧不可阶	语言
天高皇帝远	词汇
河北省中医院	医院
雷克沙	电脑
合欢山	旅游
鹅銮鼻	地理
花缘	科学
炒面	美食
巴松措	生活
美野	服装
薛腾	皮具
尘垢秕糠	成语
尘垢秕糠	文化
才高运蹇	词汇
材高知深	文字
晨昏定省	词汇
惝恍迷离	词语
楚界汉河	词汇
安谧	词汇
安谧	作家
金帝	生活
胡桃	植物药
胡桃	药品
欧锦棠	百老汇
新疆杨	植物学
程蔚	人物
偏执狂	分子生物学
万固寺	生活
格洛纳斯	定位
硬是	词汇
硬是	文学
三刀	小吃
茄子干	生活
视为畏途	成语
里丑捧心	文学
跼天蹐地	国学
谢旭峰	体育明星
溴化钠	化学
王克楠	男子
唇焦口燥	成语
吹角连营	语言
长颈鸟喙	词语
草间求活	典故
澄江如练	典故
传经送宝	文化
察己知人	词语
赤口白舌	语言
乘龙佳婿	词语
市井之徒	语言
低压	文学
事不关己	词汇
出谋划策	词汇
驳岸	气象
无风起浪	文化
卤肉饭	美食
小灵狗	宠物
李铭顺	人物
池鱼之殃	词汇
华谊	上海
高梁桥	文明
凉糕	生活
得饶人处且饶人	词汇
中国船舶工业集团公司	船舶
鳐	鱼纲
任法融	人物
胃痉挛	医学
氯碱	化学
席珍待聘	文学
尼龙	科学知识
伍仕贤	明星
和卓	礼仪
一颦一笑	成语词典
冁然而笑	国学
急风暴雨	成语
风雨萧条	典故
风风雨雨	语言
危如朝露	文化
霜露之病	成语
霜露之病	语言
外卡	名词
梅花桩	武术
茶盏	古董
脚臭	细菌
医宗金鉴	清朝
蔡梅	观赏植物
春兰	草本植物
古民居	山西
昌化江	地理学
码	字典
文水县	山西
交口县	地名
石楼县	地理
赵易亚	军事家
解长林	军事家
游标	地理
上海人民美术出版社	出版社
黄炜华	少将
病毒库	病毒
少年宫	生活
伏尔加格勒	地理
占星学	自然科学
通则	法则
筑室道谋	语言
凌波仙子	福建
贺东生	人物
强化	科学
蜾蠃	昆虫
蜾蠃	膜翅目
指令系统	自然科学
操作码	计算机系统
尤太忠	名人
乐雷发	诗人
越野	户外
欣然自得	词语
郑坤良	游泳
傅全有	将军
重振雄风	词语
触毛	生物化学
山西省脑瘫康复医院	医疗机构
谷善庆	人物
生物质能	太阳能
萧然物外	文学
张维石	人物
染色质	免疫学
灰质	神经系统
韩国国会	政治
颈	应用科学
无明	佛教
中波	自然科学
惜指失掌	典故
惜指失掌	汉语
杨树根	将军
余光茂	人物
李俭珠	名人
郭延林	人物
国际歌	共产党
伊文	将军
伊文	人物
忧谗畏讥	文化
优游自若	语言
优游岁月	语言
优孟衣冠	词语
乐善仙	自然
乐善仙	观赏植物
罗有荣	军事家
忧形于色	文化
佐治亚州	地名
南方日报报业集团	文化
雪蛤膏	文化
宁国市	地理
密山	鸡西
张宗禹	历史
文进勇	越南
唐晨	明星
银杏	自然
祥和	词汇
冠	文字
蓝花	百合
竞买人	拍卖
卓仁禧	武汉大学
家用电器	电视机
折扇	艺术
串珠	饰品
扎囊县	西藏
手板	工业
农夫山泉	互联网
枢机主教	基督教
张元培	人物
耿锡祥	军事家
叶松盛	人物
不知就里	词语
裁月镂云	成语
朱蓓薇	人物
裴丽生	人物
吉合	人物
施雅风	地理
叶企孙	教育家
周同庆	学者
钱志道	人物
梁伯强	生物学家
王家楫	动物学家
尤加利	药品
东方闻樱	名人
杨氏蝶	观赏植物
冯亚衍	艺术
玉米浓汤	美食
连体服	制服
概念股	证券
鱼拓	手工艺
熔化	分子生物学
边景召	绘画
吉服	服饰
鲁滨孙	英国
处方	生物化学
万尼汁	饮食
中心	术语
刀币	中国
灵溪	苍南
灵溪	浙江
带球	术语
普者黑	云南
新罕布什尔州	区域
新罕布什尔州	美洲国家
北卡罗来纳州	区域
田纳西州	阿联酋
贝克岛	历史
激光头	光驱
采样	科学
科斗文	书法
电子染色	分子生物学
电子染色	科学
菌核	自然科学
菌索	生物化学
分生孢子	生物
白水江	自然
罗源县	地理
永泰县	福建
基因毒性	自然科学
贯	汉字
用户组	计算机技术
照相术	理论物理
人口学	环境工程
江瀚	教育家
患难与共	成语
今何在	著名作家
日语	文化
仰月	钱币
长揖	生活
中国金币总公司	奥林匹克运动会
中国人民银行	社会
定性分析	分析化学
戴元本	物理学家
青檀寺	城市
管惟炎	科学
唐孝威	学者
倪嘉缵	化学家
唐有祺	北京大学
长江后浪推前浪	文化
龙凤饼	小吃
理论物理学	物理学
狗嘴里吐不出象牙	典故
换汤不换药	成语
磨刀不误砍柴工	词语
琼斯	体育人物
来因去果	词语
居不重席	词汇
赵友钦	历史
王赤军	将军
玻璃仪器	医药公司
广州歌舞团	文化
李夫克	人物
李夫克	名人
黎晖	人物
苏吉丹	地理
北京首都体育馆	体育馆
厅	汉字
钱逸泰	教师
王青圃	教师
木卫六	科学
天卫一	宇宙
天卫三	天王星
天卫七	宇宙
天卫十一	天王星
戴文彬	军事家
盐山县	中国
颜伏	少将
宝轮镇	广元
驹齿未落	熟语
阿斯巴甜	化学
叶大年	科学家
举国一致	汉语
酒有别肠	语言
怡情悦性	汉语
怡声下气	词语
鸠集凤池	语言
无所作为	词语
惠然肯来	词汇
傅传作	名人
微波遥感	科学技术
行号巷哭	汉语
顽梗不化	汉语
趁人之危	文化
闻一知十	语言
回嗔作喜	汉语
贯朽粟腐	成语
西安咸阳国际机场	机场
亚洲电视	生活
膏腴之地	汉语
汹涌澎湃	词语
甘贫乐道	语言
商业软件	商业
过化存神	成语
戴尔公司	电脑
丁初	历史
常仲连	人物
丁缓	历史
涂学忠	人物
及笄年华	文学
盘湾镇	村镇
小金丸	应用科学
大款	新词汇
苏神	人物
海通镇	村镇
专有名词	语文
泰山梁木	文化
艋	字典
五指毛桃	植物学
丁元公	历史
丁悚	历史
爷饭娘羹	文化
广宣	历史
莫德尔	元帅
马锦	伶人
鲜于枢	北京
潮汐能	能源科学
扎染	艺术
硬盘驱动器	应用科学
黄祯祥	教授
梁植权	农学家
外汇牌价	技术
王伏雄	名人
正蓝旗	地理
丁国瑜	科学
谷德振	科学
郝诒纯	科学
穆恩之	科学
钥匙链	生活
叶连俊	科学家
arpanet	网络
侯寨乡	地方
滑移线	地质学
黄花鱼	八大菜系
水文地质	地球科学
硕士论文	论文
桥接	网络
锡金	王国
南孚	电池
德仁	日本
扣杀	运动
巴塞尔	地理
望断白云	成语
望断白云	词汇
中国共产党第七次全国代表大会	科学
一时半刻	文化
人地生疏	文化
清昭陵	风景
防潮纸	印刷
说来话长	熟语
罚一劝百	熟语
罚一劝百	汉语
何乐不为	文学
徐文礼	将军
枉勘虚招	语言
马绅	名人
马时阳	历史
马士图	名人
栗在山	人物
非关税壁垒	开放
马田	人物
科技日报社	媒体
马延禧	人物
马应祥	人物
桂绍忠	将军
马元震	人物
马瞻	人物
马子英	历史
富室大家	词汇
马骀	名人
小气候	自然现象
法制日报社	报社
李百万	演员
查国桢	军事家
杨家保	人物
奥勒松	挪威
山语	历史
卫光远	历史
腻子	材料学
于芹	人物
张书祥	人物
于钟岳	人物
胡立信	名人
卞承之	历史
邓碧珊	瓷器
上海市南洋模范中学	高中
方登峄	人物
方登峄	名人
石化	地质学
无理取闹	成语
邓演达	政治家
扇枕温席	成语
帝力	首都
扒皮	刑罚
报喜鸟	时尚
李解	武侠
春笋	饮食
bjca	安全
水洞	生活
聂绀弩	名人
凤栖	历史
戈宙琦	历史
公孙宏	西晋
勾涛	历史
计楠	历史
孔汪	名人
孔文卿	历史
孔公恂	人物
孔继尧	人物
毛楚哲	人物
毛会建	名人
毛树棠	人物
毛用坤	名人
甲壳质	医药
王籍	历史
王廷秀	人物
王元规	人物
王播	诗人
王步青	历史
王步先	人物
霍维茨	美国
王畴	历史
王大经	人物
暖洋洋	词语
王道亨	历史
胡应湘	香港
王观泉	美术
王景辰	历史
王肯堂	人物
王鸣盛	伯爵
王命岳	官吏
王乔士	历史
王庆麟	科学家
王神爱	人物
王时翔	历史
王树忱	画家
海平面	地理
王嗣宗	名人
王桐孙	人物
王万钟	人物
水团	自然科学
王宰	历史
王之敬	清朝
物质文明	法律
王仲诚	元曲
幽静	文学
王拙	人物
王卓倩	历史
鼎沸	词汇
哗然	汉语
纸落云烟	语言
南贩北贾	语言
应时对景	语言
比价	商业
九泉之下	典故
专柜	金融
专柜	经济
面值	证券
熊经鸟申	典故
蝇声蛙躁	成语
纯一	人物
十八般兵器	军事
斗牛舞	艺术
季戊四醇	化学
蜗	汉字
公羊传	文化
进步党	戊戌变法
思州	古代史
曹建猷	北京大学
钱钟韩	教育家
张恩虬	科学
王守武	科学家
王业宁	科学家
黄葆同	人物
沈家骢	学者
沈家骢	科学
郭景坤	科学
蒋锡夔	化学家
吴全德	物理
圣路易岛	地理
张广学	昆虫学家
礞石滚痰丸	医学
陶泽如	金马奖
客流	统计学
三包	经济学
出行	生活
种田	汉语
何麟	艺术家
封二	书籍
马晓山	名人
磷酸氢二钠	药理学
奥林达	巴西
外来词	社会科学
头痛	科学
罗湘涛	军事家
王淮湘	山东
孔峭凡	军事家
朱家胜	将军
轻巡洋舰	社会
柳原爱子	日本
纳雍县	高原
张国传	名人
路惠男	人物
闪存卡	网络
佩鲁济	意大利
栗姬	后妃
夏鼐	考古学家
蜕皮	生物
龙豆	农作物
弘化公主	唐朝
千代田区	日本
佐饔得尝	语言学
负薪救火	语言
土壤污染	土壤
easy	杂志
质子泵	生物化学
佛头着粪	词语
忿然作色	词汇
春生秋杀	成语
齿牙春色	熟语
齿牙春色	汉语
赤心相待	熟语
触物兴怀	成语
才疏意广	典故
寸丝不挂	熟语
中央芭蕾舞团	机构
蠕变	地球科学
出以公心	成语
张宇豪	明星
王墀	举人
菜蔬之色	汉语
出手得卢	文化
周行文	玄幻
扣球	术语
鸣鼓而攻之	文学
韦季	人物
文彭	书法
尹昌隆	人物
尹翔	历史
路易丝	文化
弘景	人物
弘景	历史
卢炳	人物
卢东牧	人物
卢弘宣	历史
卢宣	历史
卢邈	人物
丘仲孚	名人
石成瑞	人物
史康	人物
世善	佛教
田黎明	美术家
康拉丁	国王
李坏	文化
段延庆	武侠剧
工藤静香	人物
嫣然	美丽
甄美莉	人物
吕韵季	人物
秀出班行	汉语
远水不救近火	语言
华亭派	艺术
华亭派	派别
泰夏安-普林斯	体育
褚士宝	人物
何家产	少将
吴纯仁	将军
杰奎琳	人名
肖远久	名人
李如洪	将军
玄畅	历史
叶范	历史
叶桂庭	名人
杨福愉	科学家
常印佛	地质学家
蔡睿贤	学者
左晟	人物
高镇同	航空航天
黄克智	科学家
安彦	名人
欧阳予	物理学家
孙钧	科学家
闻邦椿	科学
成知训	历史
关生	历史
困知勉行	词语
图标	操作系统
林励吾	科学
袅袅娉娉	俗语
许学彦	科学家
许学彦	海洋学
江德量	人物
钟万勰	科学家
鸟散鱼溃	成语
云涌飙发	汉语
云涌飙发	词语
江上渔	人物
女大须嫁	成语
怒形于色	文化
匡源	名人
刘边	历史
云屯星聚	熟语
朱孔易	名人
云屯飙散	词语
朱廷柱	历史
朱纬	人物
朱义	历史
朱印然	人物
朱在勤	人物
朱泽云	人物
朱樟	人物
刘大绅	艺术
沉默子	自然科学
刘国用	历史
圆周率	科学
刘家谟	历史
进化树	分子生物学
进化树	生物学
图拉姆	足球
图拉姆	运动员
刘理德	人物
刘商	唐朝
刘师朱	历史
刘四公	人物
刘希	历史
刘亚兰	人物
刘亚兰	历史
刘有仪	人物
刘宰	人物
刘载	名人
刘自鸣	人物
巫山长江大桥	长江
刘珙	诗人
刘铨	名人
吕抚	人物
全贤	人物
任德筠	历史
任广	人物
堪察加州	欧洲
阮安	名人
师松龄	人物
师宜官	人物
孙承泽	书法家
孙从嘉	历史
孙鼎臣	名人
孙羹笼	人物
孙桂	人物
孙克纲	艺术
孙兰嫒	人物
steelheart	音乐
孙楼	人物
孙齐蓥	历史
孙芹	人物
采光	摄影
孙云鸾	历史
孙枝	人物
孙智敏	人物
汤敬	名人
汤遇昌	历史
伍德彝	历史
银兰	生物
邢敦	人物
许宗衡	湖南人
羊戎	历史
羊士谔	人物
朱常涞	人物
朱华玉	历史
欺公罔法	词汇
窃钩窃国	词汇
朱曜奎	名人
交梨火枣	汉语
千端万绪	国学
千刀万剐	文化
举例发凡	语言
专利法	经济法
陈静心	历史
陈九川	理学家
畸轻畸重	应用科学
捐躯殉国	典故
陈龄	名人
陈鸣琼	历史
积日累久	成语
经史百子	成语
鸡声鹅斗	成语
陈树菱	历史
反转片	生物化学
陈所蕴	历史
江山如故	文化
陈循	人物
陈豫钟	人物
陈运彰	人物
詹鼠	餐饮业
陈璜	人物
漂白	分子生物学
杜成均	名人
粉皮	特产
杜介	名人
杜景祥	名人
救经引足	成语
救经引足	国学
杜首昌	名人
杜庭珠	历史
杜霄	名人
杜易简	唐朝
何景福	人物
何振志	中国
李茂之	历史
李献能	历史
分动器	生活
躁狂症	医疗
李道士	人物
李富孙	人物
穷不失义	文化
旦旦而伐	成语词典
旦旦而伐	国学
李景孟	人物
李克弱	书画家
李灵夔	名人
李流谦	诗人
李绵璐	人物
李培厚	名人
萧德明	军事家
铺张扬厉	语言
李士桢	历史
李世熊	书法家
李寿明	历史
李无惑	历史
李象坤	人物
大吹法螺	国学
鼎铛有耳	词语
李延生	国画
道大莫容	熟语
东风浩荡	汉语
倒冠落佩	词汇
李醉梅	人物
李佐贤	人物
李绛	唐朝
李贻德	人物
李懋绪	历史
陆采	名人
陆长源	诗人
陆升之	历史
陆士季	人物
陆玩	人物
陆完	人物
震中	通论
邵博	人物
邵长蘅	历史
邵景康	历史
沈炳震	人物
沈伯兰	历史
湖南农业大学	高等教育
沈初	人物
沈春	历史
沈度	书法家
沈复吉	人物
沈鹤微	人物
沈鉴	名人
沈润	人物
沈诗	历史
沈树玉	历史
沈天启	历史
沈伟济	历史
心得安	科学
披沙拣金	成语
平流缓进	词汇
铺锦列绣	成语词典
凭几据杖	国学
万壑争流	文学
巨	汉字
万象森罗	成语
无头告示	成语
无私有弊	成语词典
无私有弊	语言
闻声相思	词语
吴头楚尾	词汇
无庸讳言	文化
撒豆成兵	成语
衔环结草	汉语
嫌贫爱富	国学
协私罔上	成语
协心戮力	文化
胁肩低眉	文化
胁肩累足	语言
斜头歪脑	典故
沈应山	历史
沈宗敬	书画家
沈禧昌	历史
宋大业	人物
宋复	历史
星驰电发	文化
星离雨散	成语词典
宋讷	安阳
宋徵舆	人物
宋汶	历史
苏文举	人物
苏宜	人物
苏照	人物
南果梨	水果
天坛公园	文化遗产
汪建新	医师
汪学金	历史
汪永祚	历史
汪元青	人物
汪圻	人物
汪楫	历史
吴大震	名人
吴谷祥	绘画
吴绳基	人物
吴通微	人物
吴西逸	元曲
吴铸	人物
吴谔	诗人
顾兰君	文化
严保庸	人物
严济	人物
严澍	人物
杨至质	历史
杨衡	人物
杨景贤	人物
杨柔胜	历史
杨寅秋	历史
杨载鸣	历史
余秉楠	教授
镲	民族乐器
张克信	历史
张朗	历史
张孟容	名人
张尚思	历史
竹簧	民族
张兆圻	历史
张子益	历史
张表臣	历史
张泊生	人物
张道一	苏州大学
张尔岐	历史
张金盛	历史
张文台	人物
张习孔	人物
张以文	历史
张贞生	历史
张贞生	名人
张榕端	历史
邹必显	历史
邹复雷	历史
帮	释义
邹绍先	历史
邹士夔	人物
邹显臣	历史
宝谦	人物
范述曾	历史
范迪宽	画家
范凤翼	人物
范来宗	历史
范隆坤	人物
范隆坤	历史
移	解释
再融资	金融
季道桢	人物
季桂芬	人物
季士林	历史
金德枢	历史
金一甫	人物
金可久	人物
金林	历史
金蕊	清朝
金森	足球明星
金绍堂	名人
金廷椿	人物
金野樵	人物
金友谟	清朝
金元吉	历史
金远	人物
金肇泰	历史
金侃	人物
居简	人物
统计图	科学
林宠	历史
林纯贤	历史
林侗	历史
林古度	名人
林庶	名人
林韵	人物
林樾	历史
罗王常	人物
牛叉	语言
行远自迩	成语词典
行险徼幸	词汇
行行出状元	语言
形格势禁	成语
屈鼎	中国画
荣辉	人物
尚君砺	画家
尚其亨	历史
英若识	历史
郑魁	人物
郑魁	历史
郑廉	历史
郑清之	人物
周兴嗣	历史
周拔	人物
周拱藻	历史
周建夫	教授
周京	人物
周良士	历史
周启明	人物
寻行逐队	词汇
寻行逐队	成语
周序鸾	人物
周兆通	人物
周整	历史
稀树草原	自然
身家性命	文化
周弼	人物
周翥	历史
尿不湿	用具
卓晚春	人物
宗言	人物
嘘枯吹生	语言
费念慈	历史
粟红贯朽	词汇
伤弓之鸟	文学
贺贻孙	人物
洪桂林	人物
洪周禄	人物
胡宝仁	人物
胡长泰	人物
胡积堂	历史
王兴超	人物
胡其孝	名人
胡起昆	人物
胡勤尧	人物
胡汝嘉	人物
胡铣	历史
胡行简	历史
胡裕培	人物
胡之纲	人物
胡直	历史
皇甫规妻	历史
姜宝星	画家
排忧解难	成语
柳弘	人物
丝恩发怨	文化
施忠	人物
思道	历史
宣坦	人物
姚敦	人物
姚漓焘	历史
姚汝颂	人物
姚树勋	人物
输财助边	熟语
生栋覆屋	语言
四海波静	熟语
视丹如绿	成语
姚子敬	历史
姚铨	人物
姚镛	人物
俞实砚	人物
俞远	历史
赵博宣	人物
赵持满	人物
赵持满	历史
赵尔颐	历史
赵光涛	人物
赵怀	人物
赵良弼	元朝
赵梦朱	历史
赵叔明	人物
赵树同	雕塑家
赵天宠	历史
赵惟吉	宗室
负干涉	遗传学
旁求博考	语言
赵琦美	人物
旁指曲谕	典故
钟岳	历史
钟肇立	历史
钟毓龙	历史
祝大年	男性
喷血自污	成语
祝萃	人物
朋比为奸	成语
批亢捣虚	成语
批风抹月	文化
班惟志	历史
柴奇	人物
高继宣	人物
高甲	历史
高子庶	人物
直观图	科学
顾敏恒	名人
顾生岳	书画
顾湄	江苏
郭起元	人物
郭善明	历史
郭伟勋	人物
桓赫	人物
复制子	分子生物学
贾蓬莱	名人
倪灿	历史
聂南溪	历史
聂松岩	历史
聂田	历史
同源	遗传学
钱汉霖	人物
钱希言	历史
秦舜友	人物
秦友谅	历史
秦曰寅	历史
秦岳	历史
唐怀德	名人
唐静闲	人物
唐礼	历史
唐琼	人物
唐日昌	历史
唐士耻	名人
唐志契	历史
陶隆	历史
陶宗仪	人物
编码链	生物化学
夏尚朴	历史
夏文宪	人物
夏学崇	历史
徐甲	道家
徐九牧	历史
徐学谟	名人
殷善	历史
殷世安	名人
殷仲容	名人
袁澄	人物
袁去华	诗人
袁树	历史
袁先忠	历史
真必卿	名人
真瑞卿	人物
诸允锡	名人
奚小彭	历史
方淦	历史
陈宏绪	人物
陈瑚	历史
谷鹏楼	人物
谷清	名人
张子谦	文人
科幻片	影视
明通	词语
高腾	人物
高体华	历史
徐元杰	状元
徐元杰	诗人
徐元晖	人物
东西湖区	地理
认购证	证券
碘化油	科学
踩高跷	民间艺术
公权力	法学
卵式生殖	科学
沈学础	科学
支志明	名人
吴常信	科学家
汲汲顾影	典故
熊有伦	科学
侯虞钧	人物
周本濂	物理学家
华盛顿邮报	报刊
华盛顿邮报	新闻史
稿费	科研
曹啸天	革命家
曹玉彬	历史
周惠吾	革命烈士
阴跌	金融
国际狮子会	慈善
军	说文解字
古往今来	词汇
挹娄	历史
群岛	文化
重宝	货币
重宝	社会科学
要位	术语
京沈高速公路	地理
费里	法国
费里	阿尔巴尼亚
别录	历史
外务大臣	日本
杨木贵	烈士
上海图书馆	学习
在谷满谷	成语
遭逢不偶	文学
澡垢索疵	语言
朱洁仪	明星
择福宜重	成语词典
泽及枯骨	语言
谮下谩上	文化
扎根串连	语言
空气压缩机	工业
谷芽	植物
罗仲霍	烈士
宋豫琳	革命烈士
会计分录	经济学
水陆毕陈	词典
朝不保暮	文化
朝梁暮晋	语言
十万八千里	语言
间羟胺	医疗
民不聊生	词汇
杨大将	历史
十步芳草	文学
康克由	柬埔寨
惶	汉语
杂说	词语
陈翠婷	人物
郑怀贤	体育
韦圃	名人
尹积昌	雕塑家
尹沅	人物
支仲元	人物
徐才	中国
徐才	地理
冯从吾	儒学
冯恩	人物
乐黄日	历史
龙升	人物
卢清	历史
杀鸡抹脖	词汇
石恪	郫县
史尔祉	历史
史相	历史
史麟	历史
田谦	人物
叶圭祥	人物
叶圭祥	历史
林毅夫	经济
叶树滋	世界语
尿激酶	神经科
印湘	画家
安靖镇	乡镇
声动梁尘	词语
江僧宝	历史
枕典席文	文化
江树屏	人物
生发未燥	词语
振兵释旅	成语
振领提纲	语言
江兆锡	人物
振穷恤寡	语言
镇日镇夜	语言
争长竞短	文化
刘次泉	历史
刘仁轨	将军
刘肃芬	历史
执经问难	文学
齐捷	人物
直言极谏	文化
李宝台	人物
李文奎	人物
李用周	名人
李振裕	名人
李枝郁	历史
李自流	人物
李鹗	人物
邵恒秋	人物
沈善登	人物
沈玄华	名人
宋燧敬	历史
汪德溥	名人
汪关	人物
越城桥	艺术
汪潭民	人物
质疑辨惑	汉语
汪铎洋	人物
吴保初	庐江
炙鸡渍酒	词语
吴龙光	历史
吴龙光	名人
吴磐	名人
严怪	历史
智小言大	成语
张恭嗣	名人
曲沃	地理
张师宪	历史
张育司	名人
张璧	历史
张鸾	文学
忠心赤胆	中文
范庭玉	人物
金启	人物
金善	人物
钟鼎人家	语言
钟鼎山林	成语
林鸿增	人物
林其茂	历史
林少初	人物
林烃	林氏家族
罗幼新	军区
茅元仪	明朝
苗神客	历史
庞元济	艺术
众口一词	文化
郑棠	历史
郑文中	人物
重义轻生	词语
周起岩	历史
周绍潦	人物
周守忠	名人
周水新	人物
周思濂	历史
周颂	人物
周闲	历史
周星誉	名人
周渊	历史
周蕴文	名人
周鼐	历史
宗泰	名人
柏盟鸥	人物
柏雪村	人物
保希贤	历史
查为义	人物
查祥	人物
珠圆玉洁	国学
费道宁	人物
洪恕	历史
洪颐煊	人物
胡宝泉	人物
胡寄樵	书法家
胡贞开	历史
姜曦	人物
过去分词	语言学
施邦华	名人
施祁	历史
施友龙	历史
思齐	历史
姚谦	人物
姚秦	人物
俞文豹	文化
赵澄	历史
赵叔盎	历史
赵之璧	演员
赵之璧	音乐
祝丘	人物
荀信	人物
高元美	人物
郭都贤	湖南
郭将军	历史
郭起隆	历史
郭昱	历史
浦惠	人物
钱陈群	名人
钱山帘	人物
钱惟善	人物
秦长安	历史
唐培	人物
唐愫	人物
陶景真	历史
陶宗暹	人物
陶宗暹	历史
翁王瑾	名人
夏之霖	历史
夏昶	历史
徐淑	人物
殷树柏	人物
袁服孔	人物
袁湘	人物
袁樵云	人物
陈汉卿	人物
俞芳	越剧
俞芳	海宁
钟秋塍	历史
高士华	人物
音量	音乐
内耳	中医药学
赵伊坪	人物
赵敬夫	革命烈士
徐世奎	人物
肠粉	湘菜
铢分毫析	文化
琼中黎族苗族自治县	海南
逐末忘本	词语
主少国疑	成语
敬霞节	贵州
拄笏西山	成语
南莫	城镇
神思者	演员
壮士解腕	成语
追云逐电	语言
酌古御今	文化
锱铢不爽	语文
龇牙咧嘴	文化
天涯比邻	语言
同舟敌国	熟语
善罢甘休	成语
左支右吾	文化
为德不卒	熟语
左邻右舍	文化
冷却系统	能源科学
望风捕影	汉语
作小服低	语言学
万古长青	汉语
晚节黄花	文化
坐运筹策	语言
坐薪尝胆	语文
文理不通	语言
望风而逃	词语
改行为善	词典
改姓易代	文化
痛痒相关	汉语
张缉	历史
司马望	东汉
银红	颜色
银奖	词语
银奖	语言
银匠	词语
概日凌云	成语
为丛驱雀	语言
金石之交	语言
阿爸	宗教
肝髓流野	成语
诗篇	圣经
高人一等	词汇
高天厚地	成语
高飞远走	文化
高高在上	熟语
相门有相	国学
高情远致	文化
高垒深沟	语言
高顾遐视	语言
割肉补疮	词典
歌功颂德	词典
革心易行	语言
革图易虑	国学
格杀勿论	词语
隔屋撺椽	词汇
萨满鼓	乐器
根株牵连	词语
达玛如	乐器
更深夜静	文化
梗迹萍踪	文化
公正无私	语言
公正廉洁	词典
公平合理	成语
公私兼顾	词汇
公是公非	成语
功成名遂	文学
功成名遂	词汇
功成名遂	文化
攻心扼吭	文化
王永珀	球星
范运杰	足球
时态	语言学
吴新涛	科学家
色氨酸	药品
郑守仪	科学家
石耀霖	物理
刘宝镛	人物
刘宝镛	科学
柳百新	名人
狗盗鸡鸣	字典
狗头鼠脑	文化
垢面蓬头	语言
姑妄言之	词汇
孤儿寡妇	文化
孤雌寡鹤	词汇
孤雏腐鼠	文化
骨化形销	成语词典
骨肉相残	文化
骨瘦形销	词汇
鼓腹含和	文化
系列学习	社会科学
玩岁愒日	词汇
枉突徙薪	文化
张启龙	人物
弗莱福兰	地名
糊口	词语
查询	词典
分析	词汇
霍城县	中华人民共和国
唐布拉	新疆
机翼	飞机
糜蛋白酶	药理学
糜蛋白酶	科学
李青生	教练
姜翠华	体育
高娥	辽宁人
顾影弄姿	词语
木威子	中药
阿普洛尔	医学
宋妮娜	人物
孙彩艳	人物
王晓竹	运动员
温健公	革命烈士
王少奇	人物
秦家柱	革命烈士
刘培久	英烈
亚肩迭背	国学
耶	古文
沟	昆虫学
泥足巨人	语言
年谊世好	汉语
仲维萍	体育人物
印毅俊	运动
泥塑木雕	词语
能说会道	词汇
泥牛入海	社会
扪心无愧	语言
粲	特色小吃
炮凤烹龙	词汇
猿猴取月	语言
自卸车	应用科学
恻	汉字
莫予毒也	文化
全兴	文化
气井	文学
密约偷期	语言
气魄	文化
气眼	休闲装
鸟革翚飞	语言
南箕北斗	成语
次	理论物理
杨雀衔环	语言
关门大吉	词语
关门大吉	语言
观山玩水	国学
观眉说眼	文化
曳尾涂中	文化
冠上加冠	词语
鸟枪换炮	成语
弄性尚气	词语
弄性尚气	汉语
骢	汉语
奴颜媚骨	词语
龙血玄黄	词汇
光前裕后	语言
光彩夺目	语言
光焰万丈	熟语
立于不败之地	词汇
赖有此耳	词汇
锋不可当	文学
龟毛兔角	宗教
陈开路	名人
纶音佛语	文化
扫雷舰	历史
瘩	语言
鞑	汉语
利用厚生	词汇
袋	字典
迨	语言
骀	汉语
但	姓氏
风言风语	典故
良药苦口	成语
廉远堂高	词语
里应外合	成语
乐以忘忧	词语
冷眼相待	语言
驴肉	中药
蛇肉	中药
闵损	春秋
落叶知秋	成语词典
桌	舞蹈
羽毛球拍	运动
闺英闱秀	语言
聊以自娱	词语
鬼哭粟飞	汉语
大金刚	人物
耶稣会	梵蒂冈
策应	篮球
国破家亡	语文
国富兵强	汉语
浊点	日语
谋为不轨	语言
阿爷	汉语
朽木不可雕	国学
葛墨林	人物
秦大河	人物
无根水	医学
卡尼汀	减肥药
枪托	军事
生银	金属
奇蹄目	生物学
海涯天角	语言
海涵地负	典故
络子	民俗
亥豕相望	文化
骇心动目	文化
苗锦	染织
别除权	社会
追加	计算机系统
圣驾	词汇
圣驾	文学
续弦	民族
乐以琴	四川人
焦守健	革命烈士
姜克智	烈士
黄木芬	中华
郭继成	中华
碧牡丹	诗词
越溪春	文学
八一	纪念日
基因枪	自然科学
叨	字典
低	语言
抵	语言
底	人物
解佩令	宋词
诋	汉字
店	汉字
淀	汉字
叼	字典
跌	汉语
钉	语言
悍然不顾	成语词典
墨子泣丝	国学
好酒贪杯	词语
好为人师	词汇
豪放不羁	语文
豪情壮志	成语
明正典刑	国学
河同水密	成语
河东狮子	成语
河清海晏	成语
马耳东风	成语
河清云庆	语言
鹤长凫短	语言
鹤唳猿声	文化
黑风孽海	成语
希腊字母	自然科学
恨入骨髓	成语
横戈跃马	文学
横金拖玉	文化
横恩滥赏	文化
闳言崇议	成语
闳识孤怀	文化
鸿商富贾	文化
狐鸣枭噪	文化
胡越一家	成语
鹄峙鸾停	汉语
阶地	环境工程
怙终不悛	词语
哗世动俗	文化
化零为整	文化
划地为牢	典故
明察暗访	语言
琵琶别抱	文化
末学肤受	汉语
流水桃花	词汇
量小力微	汉语
流水落花	词语
累瓦结绳	成语
消费水平	心理学
牢什古子	词汇
老大无成	熟语
鸾孤凤只	成语
林寒洞肃	语言
红白机	game
劣迹昭著	词汇
累教不改	词语
烈火辨日	熟语
烈火辨日	词语
料敌若神	词语
龙肝凤髓	汉语
伊斯兰教历	科学
常宝丰	相声
苏启强	人物
色谱法	药品
坏法乱纪	语文
司马称好	语言
配子体	分子生物学
邱义仁	台湾
恍如梦寐	词典
灰身灭智	术语
挥沐吐餐	词典
小山智丽	人物
周俊勋	体育人物
毁不灭性	文化
收官	围棋
美国新闻署	美国
泻白散	科学
源泉万斛	成语
邪门	词典
怨女旷夫	文化
爱尔兰岛	英国
惠大贵	糖尿病
吴艳艳	人物
乌尔塞斯	人物
乐嘉陵	学者
魏意民	足球
陈士橹	人物
林宗虎	学者
左旋肉碱	化学品
混混沌沌	语言
混然天成	故事
魂销目断	成语
活眼现报	文化
火冒三丈	语言
祸福相倚	文学
豁然贯通	语言
土地利用	土地
林宸希	音乐
长安杯	奖项
朱致平	将军
关盛志	军事家
韩念龙	艺术
李子元	画家
稀盐酸	药品
中央革命根据地	风景区
维赫恩	人物
陬	汉字
独行其是	文化
独行其是	语言
阿世媚俗	词汇
峨冠博带	语言
恶衣菲食	语言
恶言厉色	文学
饿虎扑食	成语
反正拨乱	语言
地面沉降	地理
班廷	加拿大
更衣	文化
返观内视	语言
贝利尼	歌剧
方言矩行	词典
方桃譬李	成语
色度计	科学
风蚀	地质
固定沙丘	土壤学
脱毛	医学
宝鼎现	词牌名
破瓜之年	语言
存储卡	手机
造陆运动	地球科学
肚	字典
匵	文字
剫	词汇
塅	字典
林英安	安徽
奤	汉字
宦乡	外交家
放刁撒泼	词汇
披毛索黡	典故
段玉林	革命烈士
兑	方言
垖	词典
頧	语言
批红判白	成语词典
符信	集邮
泼天大祸	汉语
传抄	文化
肉眼惠眉	词典
人一己百	词典
族长	部落
门楼	民俗
牛蒡	菊科
荆泉	旅游
旋复花	应用科学
统计力学	物理学
野依良治	日本
垡	汉字
文圣	中国
覆盖率	自然科学
棍术	剑术
阏	汉字
拊背扼喉	成语
反悔	文化
吴毅将	影视
反目	语言
朱之瑜	明末
放言高论	文化
放情丘壑	文化
放达不羁	典故
飞沙走砾	成语
飞鸟依人	词语
飞觥走斝	文学
飞鸾翔凤	成语词典
分茅胙土	成语词典
分劳赴功	语言
分丝析缕	成语
焚骨扬灰	成语
神机营	清朝
贾马里	足球
贾马里	突尼斯
焦头烂额	文化
目不窥园	文化
镇雄县	云南
彝良县	旅游
虚情假意	词语
酸文假醋	典故
恃强凌弱	国学
通权达变	词汇
通风报信	文化
亚硫酸氢钠	化学
佐贺县	日本
千步金沙	地理
布鲁赫	德国
分段	生物化学
宝玑	艺术
丰收	作家
好行小慧	文化
榉	医药
合浦还珠	汉语
何足介意	成语
何所不为	词典
闳言高论	文化
宪章	词语
宫部美雪	日本
剡溪	浙江
灵砂	科学
黄麻紫书	成语
横眉怒目	成语
撒痴撒娇	词汇
深情厚意	汉语
三好两歉	语言
三步两脚	典故
申凤梅	艺术家
尤然	美女
鱼蛋	饮食
苞	汉字
錍	汉字
进退维谷	熟语
膑	词汇
玢	语言
尺布斗粟	语言
久闻大名	熟语
蕃	语言
较武论文	成语
炳	汉语
抦	语言
番	语言
繁忙	文学
荆山之玉	熟语
菠	词汇
泊	汉字
发言	词语
膊	语言
见性成佛	宗教
矿产	攀枝花
记问之学	词汇
邓宗海	人物
本田飞度	交通
方浩然	人物
陈伯稚	革命烈士
舫	建筑
苏晋	诗人
枋	语言
黄牌	足球
妨	语言
防疫	语言
布拉卡	神话
陈友寿	革命烈士
安普莎	妖怪
言听计从	词语
梁柏台	革命烈士
贪多务得	成语
郭士忠	天津
黄登保	人物
马树春	回族
打破沙锅问到底	语言
列土封疆	词汇
错综复杂	成语
丧魂失魄	成语
扫地俱尽	词汇
扫地俱尽	文化
杀鸡骇猴	文化
铩羽暴鳞	文化
山包海容	成语
溉	语言
郑华炽	物理学家
擀	词汇
史文焕	旅游
陈宜胜	山西
牛斗虎	艺术
山长水阔	词典
beaidid	名人
赫莲娜	美容
山陬海澨	词典
镈	音乐
山穷水断	成语
襮	汉语
讪牙闲嗑	词汇
癶	字典
郣	词典
赏高罚下	文学
上下同欲	文学
帗	汉语
上篇上论	语言
焚琴煮鹤	语言
少安无躁	词典
埗	汉语
哺	语言
身首异地	文学
身做身当	文学
麦当奴	麦当劳
身无立锥	成语
楾	汉语
驐	字典
闽菜	生活
嫷	生僻字
陊	汉语
鬌	字典
毲	服装
史忠恒	历史
龙超清	党史
龙大道	烈士
参事	职业
军临城下	成语
嚼穿龈血	文化
橛守成规	成语
掘井及泉	俗语
崛地而起	语言
倔头强脑	俗语
绝世独立	文学
绝世独立	语言
绝色佳人	典故
眷红偎翠	词汇
卷席而居	语言
芥	汉字
正	应用科学
厂	中国字
可有可无	词典
枯鱼衔索	词汇
欣	字典
芝	文化
藁	文字
搁	汉字
枯形灰心	语言
闲	词汇
见事生风	文化
陈杞	名人
一牛九锁	文化
拉什科	跳水
饮马投钱	词汇
革	语言
给	字典
贝索诺娃	体育明星
依流平进	文学
引咎自责	语言
雨迹云踪	成语
仪静体闲	文化
仪静体闲	语言
玉毁椟中	文化
蚣	汉字
猿鹤虫沙	词汇
供	汉字
供	语言
口含天宪	成语
巴松措	生活
口碑载道	成语词典
别利克	体育人物
悃愊无华	成语词典
古稀之年	成语
秋瓷炫	狐仙
谢玉铭	物理学家
谢玉铭	教育家
郑衍芬	教授
天河城	广州
甘言美语	词语
居停主人	文化
卖俏迎奸	文化
黄耀南	军事家
赤卫军	红军
虎入羊群	文化
混水捞鱼	文化
魂消胆丧	词语
议	汉字
狼突鸱张	成语
求志达道	成语
狼号鬼哭	语言
澜倒波随	熟语
阑风长雨	俗语
冠袍带履	国学
俯仰之间	词汇
付之丙丁	语言
鞲	语言
玽	文化
诟	文化
福倚祸伏	汉语
鼾声如雷	成语
好生之德	词语
痛哭流涕	词语
相位差	物理学
黄台之瓜	典故
难解难分	词语
将遇良才	成语
刘若敏	中国作家协会
鹄	语言
呱	字典
鸹	文字
宄	字典
瑰	汉字
蟽	文化
詚	文化
马铠	军事
鳞甲	生物化学
香球	词汇
香球	典故
稽首	词汇
拖男带女	汉语
托之空言	汉语
吞舟是漏	文化
吞舟是漏	汉语
吞纸抱犬	成语
吞声饮气	语言
载	汉语
李永镇	人物
推舟于陆	典故
推燥居湿	词语
葬	语言
葬	葬礼
推天抢地	语言
推食解衣	国学
推聋妆哑	典故
唣	生僻字
口腔医学	科学
责	汉字
铁心木肠	典故
蔁	汉语
掌	武术
斩	语言
曹化淳	宦官
孤苦伶仃	词汇
一呼百诺	词语
雨恨云愁	宋词
望而却步	语言
堕	汉语
哆	字典
一方之任	文学
应付自如	成语
一风吹	文化
一得之愚	文化
牙白口清	国学
一斑窥豹	成语词典
衣不解带	词汇
遌	词典
理财师	金融
喜逐颜开	文化
妿	词汇
莪	汉语
遏	语言
泠	官职
扼	汉语
昤	语言
蘦	字典
新硎初试	成语
新硎初试	语言
小小不言	语文
悬驼就石	成语
軨	文化
侕	汉字
吴市之箫	词语
蠜	文字
橎	汉字
橎	汉语
颿	语言
稳如泰山	文化
望秋先零	语言
炅	文字
衮	语言
无牵无挂	典故
辞严义正	词汇
辞严义正	语言
勫	中文
畈	汉语
万念俱寂	语言
藩	历史
党豺为虐	成语
五里雾中	词语
断壁颓垣	文化
荡检逾闲	汉语
砥砺风节	语言
得胜回朝	熟语
顿首再拜	成语
顿首再拜	汉语
茶博士	历史
刀头舔蜜	文化
与民除害	语言
羞与哙伍	成语
时不我与	词语
色授魂与	词语
大莫与京	语言
肉袒牵羊	成语
肉袒面缚	文学
破壁飞去	词汇
彷	语言
淝	文化
吠	汉语
汾	字典
无尽无休	语言
物尽其用	成语
亡戟得矛	成语
新词	词语
万箭攒心	文学
老调重谈	词语
疑	社会
鼣	汉字
剕	汉字
hs	数码相机
年华垂暮	典故
高崇熙	科学家
騛	词典
鹧鸪菜	自然
棐	词汇
赗	语言
缹	汉字
苦不堪言	词典
自然界	科学
首鼠两端	文化
鍢	语言
撞头磕脑	词典
赴险如夷	词汇
椱	汉语
寡头政治	政治经济学
谢名仁	革命烈士
彧	语言
抚绥万方	成语
菲食薄衣	成语
菲食薄衣	词汇
菲食薄衣	文化
神运鬼输	文学
黼	语言
神霄绛阙	文化
神谋魔道	词语
芾	字典
曙后星孤	词语
披罗戴翠	文学
披罗戴翠	文化
赴	汉语
辅	汉字
富	人物
表面张力	科学
哈斯效应	名称
东风波	科学
典章文物	词语
典章文物	文化
雷根斯堡	旅游
顶针续麻	汉语
咔	汉语
喀	字典
孕妇	服装
闶	汉语
基础代谢率	生态学
精子库	生物
核蛋白	遗传学
梗泛萍飘	成语
峡	文字
萋	汉语
恩重泰山	语言
浮白载笔	汉语
浮白载笔	语言
绦	汉字
庭	汉字
李祖原	建筑学家
未	字典
无启民	社会
身轻言微	国学
身操井臼	典故
深入膏肓	词汇
深入膏肓	典故
深见远虑	词汇
深见远虑	词典
深情底理	语言
神工鬼力	词语
神工意匠	词汇
神采英拔	语言
麻疹病毒	内科学
盖仑	古罗马
开刀	词汇
调制	应用程序
聿	汉字
民办教育	成人教育
龙蟠凤翥	词汇
拉索	科学
离蔬释蹻	成语词典
揎拳捋袖	成语
须眉交白	国学
轮台	地理
阅人多矣	文化
奥姆斯特德	景观设计
岪	汉字
冹	汉字
敷	汉语
孵	语言
幞	字典
旯	汉字
祴	字典
骑马找马	文化
亥	词汇
醢	汉语
酣	汉字
捍	字典
刘宝楠	文化
何纪光	民歌
蝜	汉语
顺	汉字
打喷嚏	医学
郭明辉	人物
徐则臣	名人
野芋	医药
鹨	鸟纲
肃	文学
区	文化
大三线	军事
茫茫苦海	成语
谩	汉语
樠	汉字
蔓蔓日茂	成语词典
鹿药	中药
茆	汉语
一步一趋	文化
贫无立锥	文化
艮岳	古城
藏羊	生物
桤木	植物药
田凤山	贪污
公丕祥	大法官
王理仙	生活
蒋宗瀚	社会
彭椿仙	文化
浓度梯度	生物
吕伯涛	人民法院
刘名瑞	人文
绗	字典
文艺学	文学
文艺学	艺术
叶良辅	科学家
不足为训	文化
渮	字典
姜味草	植物药
苔原气候	生物
扪虱而言	汉语
神领意造	词语
很	汉字
没世无闻	语言
亨	语言
桁	语言
哄	汉语
没屋架梁	成语
明效大验	成语
黄宗昌	即墨
于维功	近代
吴善堂	历史
韩子康	人物
窠	语言
西固区	地理
西固区	黄河
肤如凝脂	成语
肤如凝脂	语言
胙	汉字
雷动风行	成语
电掣风驰	成语
雨鬓风鬟	词语
黑龙江垦区	黑龙江
雨凑云集	语言
雨断云销	文化
雨膏烟腻	成语
雨零星乱	文化
瀖	词汇
惑	佛学
货	字典
蟪	语言
更阑人静	词汇
恚	汉字
煌	字典
诲	汉语
磺	字典
蟥	汉语
汇	字典
宦	字典
萑	汉字
哗	词汇
花楸	园林植物
香港大会堂	建筑
赵祥娃	大法官
薛易简	琴师
膜电位	生物化学
膜电位	生物学
动作电位	医学
世界名著	文学
八达	词典
熔点	科学
灴	词汇
鍧	语言
紭	生僻字
鉷	文化
鄇	汉字
骺	应用科学
黄健中	明星
唿	文化
曶	汉语
婟	语言
风回电激	汉语
风前残烛	成语词典
唐场镇	风景名胜
王元鹿	中文系
司马炽	西晋
涪江	四川
刳	汉语
殷剑	体育人物
鲜网	网页
慎重其事	成语
慎终承始	词语
毛水苏	唇形科
地耗星	水浒传
舞爪张牙	俗语
舞榭歌台	成语
磨盾之暇	成语
摩顶至踵	典故
体词	语法
罗康瑞	人物
诗云子曰	词典
诗朋酒友	成语
施衿结褵	成语词典
十年读书	词典
胡大白	校长
寒露风	气象
急流	气候
老弱残兵	文化
泪如雨下	文学
刚肠嫉恶	汉语
刚肠嫉恶	语文
刚肠嫉恶	文化
咬钉嚼铁	词组
手写体	科学
天津人民广播电台	天津
戎马生郊	汉语
乘车戴笠	文字
噢	字典
莳	词汇
莳	汉语
事	佛教
阴门	应用科学
芔	字典
眼拙	词汇
轻装上阵	国学
蠸	汉语
鰀	词汇
轻言寡信	语言
轻死重气	文化
轻身殉义	成语
潜踪蹑迹	典故
兵油子	语文
堭	词汇
群鸟	悬疑片
硅橡胶	药品
李显忠	人物
土荆皮	中草药
一扫光	中药
香港特别行政区政府	政府
画室	汉字
阴地关	地名
阴地关	关隘
罨	文学
罨	汉语
广武营	山西
齐禽	教育
皖赣铁路	旅游
京福高速公路	道路
宗角禄康	景点
十万火速	文化
臭灵丹	科学
胆木	应用科学
应城	经济
识时达变	文化
识微知著	成语
联动	流行语
染	宗教
食藿悬鹑	文化
柳腔	文化
死眉瞪眼	成语
美钞	词语
村山富市	日本首相
卖笑	词语
赵大年	著名作家
铁臂功	少林功夫
河坊街	旅游
西政	教育
关白附	科学
白珠树	中草药
金宇中	人物
金钟泌	韩国
金仲华	浙江人
井底蛤蟆	词汇
井底蛤蟆	文化
棘地荆天	文学
日偏食	自然现象
猊	汉字
马岗鹅	自然
斯布斯额	乐器
布利亚	艺术
悫	词汇
浅田真央	人物
德城区	地理
德城区	山东
休宁县	安徽
八角莲	医学
布渣叶	木本植物
疗	汉字
史美伦	董事
布加迪	品牌
眠花卧柳	成语
支柱蓼	中药
明晰	汉语
波尔多	地理
窗棂	应用科学
六曲	应用科学
工业用地	环境工程
建筑工程	建筑
肖克莱	美国
奚啸伯	艺术家
宋遇春	艺术家
伊森龙	中生代
煎	饮食
大眼	围棋
盛桥镇	乡镇
泌乳素瘤	科学
千回百转	词语
富连成	人物
厉彦芝	老旦
徐碧云	艺术家
保荐人	术语
赡	文化
叶嘉莹	学者
李顺亭	艺术家
美谈	bbs
美谈	活动
爻象	文史
号筒	民族
张占福	艺术家
刘遵义	汉学家
关正杰	香港
团风县	地名
王荣山	人物
莱山区	地理
处分	法律
土邦	王朝
溻	文学
矶	字典
寂	词汇
蓼大青叶	医学
高钾血症	流行病学
偏头痛	生活
程玉菁	人物
刘盛莲	名人
仲盛珍	人物
星海公园	生活
忶	生僻字
騞	汉语
剂	科学
畸	汉语
箕	词汇
嫉	汉语
丌	词汇
犄	汉字
噬脐莫及	语言
数码相机	单反
蒋礼	主持人
佩尼亚	后卫
红蛋	民俗文化
版税	文化
梓潼县	关隘
户外广告	广告法
土壤资源	地理
木炭	科学
设计师	文化
傅海伦	山东师范大学
孤峰	地质
孤峰	地球
切割机	工业
尿失禁	医学
董维贤	艺术家
顿口拙腮	文学
哈元章	人物
敖嘉熊	名人
胆裂魂飞	语言
砥厉名号	词汇
角峰	环境工程
羊背石	地质学
瓯越	历史
砾漠	自然科学
姚黑	姚明
于夫罗	历史
新闻线索	采访
蔡亚河	亚洲
光亮剂	机械工程
竹节参	中药
涂谨申	人物
落拓不羁	成语
加	javascript
假	语言
渐	汉语
俭	字典
建	汉字
运营	语文
傅颖	人物
铃木浩介	日剧
次序	自然科学
软广告	社会
地理坐标	自然科学
地物	地球
热敏电阻	电子
吴一峰	书画家
蓝田种玉	文学
啊哟	语言
龙胄龙	古生物
魏隐儒	艺术家
范云六	人物
叠加	应用程序
自贬	汉英词典
剪裁	自然科学
刘更另	院士
吱	汉英词典
瞷	汉语
绞	汉字
不知丁董	成语
不知颠倒	典故
噍	字典
漏洩春光	文化
胡萝卜素	胡萝卜
鲜为人知	词汇
彼得大帝湾	文化
磁控管	科学技术
锋面雨	气象
帖	拼音
3月	月份
黎玉	山东
湿度	气象
1975年	时间段
1999年	科学
1994年	大事记
1990年	时间段
甲氧氟烷	药理学
琴断朱弦	文化
难言之隐	成语
数据格式	自然科学
图形符号	测绘学
葛修润	新闻人物
现今	词典
欧进萍	学者
沈世钊	新闻人物
鲜学福	重庆大学
花絮	动画
花絮	艺术
曾恒一	院士
彭士禄	院士
主板	信息技术
玉竹	植物药
钱鸣高	中国矿业大学
紫参	自然
太阳辐射	电磁兼容
春耕	节气
劋	汉字
孂	汉语
憢	语言
讦	语言
鲒	汉字
蠘	汉字
浸	汉字
槿	语言
鹶	汉字
并赃拿贼	汉语
抱子弄孙	文化
幜	字典
毕毕	鱼类
奔走如市	词典
裃	汉字
鵸	字典
鶈	中国字
早点	词汇
鼟	汉字
缪敏	名人
熊厚发	阶级斗争
飞刍挽粒	语言
庄简集	历史
一氧化二氮	自然科学
签	汉语
雕虫末技	国学
白潭镇	河南
于渊	烈士
舡	文化
卢质	国学
吕潭乡	交通
面料	生产
夫负妻戴	语言
李医生	经济
粉骨糜躯	语言
李步云	教授
桦南县	地理
桦南县	县市
林口县	牡丹江
灸	汉字
疚	语言
朻	汉语
奺	语言
匓	语言
麔	字典
柩	人物
珇	字典
埧	语言
耟	语言
洰	词汇
檋	汉字
狊	汉字
遽	多音字
扣	字典
耍	汉语
能带	物理学
水准测量	环境工程
松岭鸟	自然
燕鸟	恐龙
奉贤区	政治
舒元	经济
舒元	经济学
缨	汉字
瘥	语文
啷	拼音
韩家寺	建筑
蔺道人	人物
西竺园	旅游
西竺园	梧州
粺	语文
纷红骇绿	文学
飞鸿雪爪	词汇
李慎之	著名作家
倪传钺	艺术家
孙正阳	人物
丰筋多力	文化
吴国盛	人名
贾云哲	明星
鱻	字典
刘宗迪	人物
李庆四	教育
抚今痛昔	语言
凤狂龙躁	文学
钮雕	古玩
菜菜	新新人类
棒棒鸡	川菜
校正	机械工程
沙菲	药品
百米桩	能源
繇	汉字
脑水肿	应用科学
小珠峰	安徽
冰期	地质学
郑州火车站	郑州
马纳里	人物
毕飞宇	著名作家
羊胆丸	药品
岑凯伦	小说家
猩猩草	草本植物
加吉寺	寺庙
艾柯卡	名人
艾柯卡	实业家
金传铃	名人
垦殖	词汇
烤肉酱	烹饪
冰帆	地理
极目	词汇
何多慧	物理学家
计氏龙	恐龙
西梁山	山川
心腹之疾	文化
附赘悬肬	词语
方足圆颅	成语
邹真俊	名人
飓	词汇
举	汉字
插座	科学技术
噘	字典
矍	字典
矍	词汇
龣	汉字
璚	汉字
要	汉语
寯	字典
鵘	语言
鵘	文字
关仁山	文学
杨燕毅	回族
杨凤一	艺术家
些	语言
骔	汉字
骑	汉语
骒	语言
验	语言
郁葱	评论家
骃	汉字
驶	汉字
孙惠芬	文学
王妍丁	诗人
埃达	史诗
甘应鑫	人物
拱手	礼节
孙绍振	人物
于默河	瑞典
张曼筠	女性
洪长庚	名人
李弥	军人
伊藤大辅	艺术
苒	语言
肠绒毛	科学
巴林奇石馆	景点
滴丸剂	药剂学
乡城县	景点
滴鼻剂	应用科学
西康	地名
初亏	天文学
发表权	社会
单国玺	新教
萨迦	文学
斯库台	古城
斯塔林	英国
巨石阵	古迹
篐	词汇
衷	汉语
净水器	家电
达濠	地理
插入语	语法
麦都思	英国人
麦都思	传教士
广义	术语
何基沣	人物
张翔玲	人物传记
专名号	排版
马辛迪	乌干达
口头文学	科学
马特莱	斯里兰卡
吴基焕	人物
青羊宫	宗教
鸟语	语言
郑孝燮	学者
鬅	字典
愍	字典
予智予雄	文学
萨丕尔	人物
萨维尼	体育人物
噻吩	科学
塞尔维亚	旅游
三化螟	生物
三甲基氯硅烷	化学
三聚氰胺	化学
牙龈退缩	医疗
8023	love
马约特岛	地理
李荣胜	小说家
阎明国	文学家
峡口	海洋学
枨	字典
分母	算术
布浦翼	漫画
布浦翼	漫画家
吉田兼好	人物
江马修	日本
自由电子	电子
红艳	命理
丁蜀镇	宜兴市
通渭县	黄土高原
古阿井	景观
圆滑	词语
渊蜎蠖伏	语言
渊停山立	熟语
渊亭山立	成语
渊涓蠖濩	熟语
蠡县	河北
遇水架桥	汉语
喻之以理	语言
永世无穷	词语
永劫沉轮	词语
饔飧不给	熟语
雍容典雅	成语
拥兵自固	语言
一坐一起	成语
一字师	词语
一重一掩	汉语
一之已甚	文化
一之谓甚	典故
一以当十	成语
一言以蔽之	文化
一言兴邦	词语
一言丧邦	词语
一言不发	词汇
一言半句	国学
委肉虎蹊	成语
一泻万里	词汇
一泻百里	语言
一笑一颦	语言
一物不知	词汇
一榻横陈	成语
一岁载赦	语言
一丝一毫	典故
一手托天	文化
荇	文字
婞	汉字
婞	文学
顽抗	词语
束手待毙	成语词典
线性	数学
螫针	昆虫
舟曲县	少数民族
栞	文字
衎	汉字
簻	汉字
广域网	网络协议
髁	应用科学
福寿齐天	语言
旷日累时	语言
追悔莫及	文学
驷马莫追	文化
饮冰食檗	俗语
墨江哈尼族自治县	地理
裤	历史
助	汉语
姬路城	建筑
加利福尼亚湾	海洋
假球	足球
查阜西	教育家
华新镇	上海
作	文学
联合国粮食及农业组织	组织
切骨之仇	成语
徐培三	人物
应龙	神话
压缩空气	物理学
压缩空气	能源
张丹露	人物
张丹露	明星
胡坚强	明星
使性谤气	成语
柳体	书法
报春花	生物化学
索文	翻译
礼义	汉语
查验	应用科学
苏米扬	信息技术
诈哑佯聋	成语
金杜	地理
拙嘴笨腮	成语
置之不顾	文化
终焉之志	文化
长幼有序	成语词典
技术引进	海关
立论	语文
雨烟	词语
神龛	汉语
上海野生动物园	旅游
临床	广东医学院
刘锡贤	名人
马雅舒	明星
虫瘿	生物
陈福今	云南人
范敬宜	学者
多吉才让	公仆
多吉才让	人大
宋瑞祥	人物
贺光辉	陕西人
黄洁夫	名人
汤洪高	山东
许其亮	名人
张钰钟	人物
包信宝	人大
任文燕	政协
夏宝龙	浙江
嘉义县	中国台湾
章猛进	余姚
蔡东士	新闻人物
卢钟鹤	人物
王厚宏	人物
李达昌	人物
陈官权	文化
王三运	简历
莫时仁	人物
陈际瓦	人物
李新良	军人
史玉孝	上将
丁文昌	人物
唐天标	人物
刘明康	财政
王宋大	广东
方嘉德	人物
翟泰丰	当代作家
翟泰丰	著名作家
张彩珍	人物
张雪轩	人物
张梓昌	学者
张思明	散文家
张勃川	外交家
张荣祥	名人
张泊泉	人物
科夫帕克	乌克兰人
张雨帆	官员
张阿舟	教授
张序登	军区
饶鸿雁	专家
赵炳安	人物
赵恒元	学者
赵修民	人物
赵国玺	学者
赵汾浦	人物
张达伍	军事家
张有龄	学者
张吉斋	贵州人
张汉祥	名人
张汉夫	政治家
张玉环	河北人
张孔修	人物
唐璞山	学者
唐章媛	学者
唐荣锡	学者
唐立民	名人
唐立民	力学
浦寿昌	政治家
谈维煦	江苏人
徐桑楚	浙江人
徐建铭	人物
徐纬英	学者
徐君伍	人物
徐运北	人物
徐运北	官员
徐华舫	科学家
徐有光	人物
徐百川	名人
徐平羽	人物
徐中玉	教授
周雅光	名人
周家炽	江苏人
周陛勋	名人
周树棠	艺术家
周春晖	中国
周贤觉	人物
周企何	艺术家
黄希坝	名人
黄玉珊	人物
萧楠森	科学家
丁广泉	名人
孙伏伽	进士
萧序常	人物
崔瑞珍	名人
崔济亚	名人
寇庆延	人物
黄锡恺	科学家
黄铭新	人物
黄席椿	名人
黄语扬	官员
黄顺兴	农业
黄香馥	学者
黄宗成	运动员
黄宝璋	河北人
韩燕如	诗人
韩秀芬	高等教育
韩克华	名人
韩少云	大师
韩天石	辽宁人
蒋祖慧	湖南人
蒋祖慧	导演
蒋孔阳	学者
导轮	机械工程
郑冠	名人
郑冠	唐朝
韦筹	人物
韦筹	名人
羊绍素	名人
寇湘	名人
梁嵩	名人
董方中	人物
越民义	人物
巢庆临	教育家
梁起鹏	学者
调车	术语
张广达	学者
张力行	山西人
张力田	人物
张颔	山西人
陈璧辉	人物
陈璞如	人大代表
陈嵩禄	浙江人
陈善铭	生物学家
陈盛清	名人
陈祜鑫	医学家
陈炳麟	学者
陈绍纲	学者
陈学诗	医学家
陈受之	科学家
陈忠经	人物
转换开关	生活
陈辛仁	政治家
陈克潜	科学
陈孝彰	体操
陈孝禅	名人
陈行庚	政治家
陈仲颐	台湾
陈廷槐	人物
陈成义	政治家
陈邦林	科学家
陈甘棠	学者
陈正琛	科学家
陈广学	学者
陈士衡	工程师
周文盛	学者
周凤歧	专家
岳宗泰	山西人
季铁中	人物
季钟朴	江苏人
和志强	将领
罗镇伟	科学家
罗荣钜	艺术家
罗玉川	政治家
罗文蔚	陕西人
马石江	名人
马克思列宁主义	主义
于黑丁	人物
于振武	军事家
于克东	人物
刁筠寿	名人
丁泽民	江苏人
丁大钧	学者
丁一三	天津人
杨贵贞	人物
杨星火	名人
杨拯民	陕西人
杨宝山	军事家
杨虎山	名人
杨析综	四川人
杨析综	艺术
1388年	年表
杨向奎	山东大学
1386年	历史
杨发勋	山东人
杨立洲	科学家
杨代蒂	名人
李后	山东人
杨溥臣	学者
杨新美	江西人
经纬线	地理
蔡齐	名人
章衡	人物
彭汝砺	名人
程宇	讲师
李常宁	名人
讥诮	词汇
菱湖镇	地理
铸石	建筑
玉爵杯	文化
五谷丰熟	词组
五谷丰熟	语言
史克忠	名人
张仁纪	名人
边贯道	历史
石琚	人物
复眼	生理
许玉赞	名人
江定仙	湖北人
江仲华	官员
汤心颐	河北人
捉影捕风	文化
安峰石	山东人
安峰石	人物
安均田	学者
齐民友	数学家
齐世荣	历史
西蒙森	体育明星
西蒙森	教练
庄钟庆	科学家
庄宏鑫	学者
庄宏鑫	人物
朱震达	地理
朱肇春	浙江人
朱家甄	人物
法事	宗教
陈翘	艺术家
陈翘	人物
陆懋曾	科学家
陆崇真	学者
陆美息	名人
直言切谏	文化
陆际光	学者
陆如山	浙江人
陆恺	江苏人
邵奇惠	江苏人
吸收	物理化学
吴维库	人物
沈祖实	四川人
朱恒兴	人物
朱厚泽	政治家
朱良漪	学者
哈梅里	明朝
朱龙玉	医学家
任凌云	政治家
任桂林	演员
任保俗	军事家
任玮	科学
曹鼐	宁晋
刘柯	辽宁人
伊藤由奈	人物
叶桂馨	学者
叶正大	教授
叶又新	画家
田淑民	艺术家
田光涛	河南人
劳钺	名人
卢世璋	学者
古里国	地理
钱家祥	人物
钱谷融	教育家
钱冬生	学者
张韶涵	音乐人
倪志钦	福建
殷震	人物
袁丽华	教育家
沈其益	名人
沈有鼎	逻辑学家
沈玉龙	培训
沈隽	农学家
汪振儒	科学
汪齐凤	女性
卓子	语言
汪汉国	人物
沙启亮	学者
沙蒙	河北人
沙蒙	名人
戛玉锵金	文化
宋淑贤	射箭
宋振庭	科学家
宋汉良	名人
袁庆志	医学家
袁行健	学者
袁正元	浙江人
袁文殊	著名作家
袁文殊	评论家
顾懋祥	科学家
顾德欢	官员
顾震潮	人物
顾淦臣	名人
顾家杰	名人
夏爵一	领导
贾庆礼	科学家
贾有权	辽宁人
中共中央编译局	教育
栗光祥	山西人
栗光祥	军事家
秦科才	湖南人
秦国栋	政治家
秦含章	人物
秦孝仪	政治
秦兆阳	湖北人
秦仲达	山东人
秦同洛	科学家
秦元勋	科学家
聂树人	人物
聂秉举	辽宁人
耿鉴庭	耳鼻喉科
李廷智	军事家
李光博	科学家
李扬汉	名人
李永裕	教育家
向腊玉	名人
向近敏	医学家
向隅	汉语
吕富华	名人
吕钟瑜	人物
吕型伟	浙江人
邢全礼	人物
邢方群	名人
成庆泰	科学家
冯德英	人物
冯德英	文学家
冯淇辉	应用科学
马纪龙	名人
马如璋	学者
杜远金	学者
杜华安	名人
杜仙洲	文物保护
杜攻	四川人
词调	古代汉语
苏勉曾	名人
儿化	现代汉语
苏廷宾	名人
苏羽	名人
苏风	法学家
芮沐	经济法
严沛然	浙江人
严志良	人物
严志良	学者
麦伟麟	学者
孙肇卿	学者
孙泽瀛	科学家
孙希岳	画家
孙生禄	飞行员
柏乡县	地理
柏乡县	邢台
孙云畴	图书馆
孙倬	人物
兴文	地理
勃利	地理
子长	地理
刘毓谷	科学家
刘曾坤	科学家
刘景伊	科学家
刘星汉	政治家
刘诗白	教育
刘泽彭	山东人
刘奉五	医学家
刘沧浪	人物
刘存信	人物
肥乡	地理
刘永峻	科学家
刘世泽	教育家
刘凤竹	亚洲明星
刘云旭	江苏人
许柏龄	人物
许实章	华中科技大学
王江巧	学者
王西彦	小说家
王书枫	河南人
王肯	人物
冯振飞	辽宁人
冯岭安	河南
冯天有	专家
白沉	艺术家
包秀明	人物
整句	名词
表音文字	字母
内存	船舶
史念海	人物
史长捷	学者
史子荣	政治家
史万春	人物
史行	越剧
申云浦	山东人
龙期威	四川人
流量计	机械工程
艾维仁	将军
艾明之	中国作家协会
厉瑞康	中北大学
邓家祺	文学
宋鱼水	名人
真意	词语
狼毫笔	书法
水龙卷	自然现象
刘定震	学者
刘定震	教育工作者
丹棱县	地理
宣恩县	地理
邓国银	四川人
丰姿冶丽	国学
邓六金	人物
尹玉宏	湖北人
尹长民	生物学家
孔厥	人物
叶忠定	艺术家
干巴利落	成语
郑丕留	江苏人
高步通衢	语言
庞学勤	明星
庞国兴	军事家
庞天仪	科学家
宗江	人物
等闲之辈	成语
林祖赓	科学家
管理员	计算机
科举制度	历史
禅宗	文化
林泽生	政治家
菡子	新四军
曹毅风	名人
曹普南	名人
曹泛	人物
曹泛	名人
女秀才	教育
戚惊萱	浙江人
陶考德	运动员
巴岱	政治家
方晓天	山西人
罗天婵	歌唱家
林衡道	台湾人
林肖硖	人物
林乐义	人物
林水龙	烈士
郭秀珍	政治家
郭秀仪	画家
郭守昌	官员
郭汝瑰	军事
郭竹瑞	学者
王祖农	名人
王济东	科学家
王复周	名人
高尚武	科学家
高攸纲	人物
姚新根	学者
贺祥麟	世界语
贺名仑	人物
贺名仑	科学家
祝延成	吉林人
侯佑堂	人物
南钥岛	水体
姚喜明	羽毛球
姚喜明	人物
贺彪	军医
洪子云	医学家
施乃良	江苏人
钟香驹	学者
俞濯之	天津人
饶碧友	人物
魏钢焰	诗人
围追堵截	故事
魏克明	编辑
魏进德	山西人
延年益寿	医学
南坎	名称
潘纪文	山西人
戴不凡	浙江人
薛鸿超	江苏人
悲哀	语文
薛伟民	官员
薛邦祺	名人
林岑	江苏人
勐腊县	高原
范棠	江苏人
茅林	学者
王泳嘉	科学家
王秉衡	工程师
瞿白音	名人
戴冀农	政治家
戴熙杰	名人
戴树珊	学者
潘福莹	浙江人
戴礼智	科学
霍松林	艺术
尼布楚	地名
黎遇航	人物
熊大仁	江西人
林一麟	科学家
林一山	人物
范钧宏	艺术家
范若愚	山西人
范文彩	山西人
争权攘利	成语
张腾霄	河南人
王旺梅	教育家
王良楣	学者
张镜人	医学
张毅忱	陕西人
张景龄	科学家
张景龄	人物
张朝汉	学者
闵嗣桂	江西人
佟柔	教育家
邹文怀	娱乐
王希周	名人
何晓青	人物
何光篪	四川人
何文俊	人物
何广乾	名人
余纪一	人物
余孟孝	江苏人
邱纯甫	人物
邱纯甫	官员
邱肖鹏	江苏人
谭显富	人物
谭庆麟	云南人
谭自烈	人物
谭申平	名人
谭文帮	军事家
吴崇筠	科学家
吴钦炜	江苏人
吴茂荪	历史
吴伯僖	学者
吴天石	教育家
吴大诚	人物
李耀增	河南人
李德尚	海洋
李溪溥	山东人
管瑞才	官员
裴先白	政治家
蔡启运	学者
蔡再杜	外交家
蔡龙云	中国武术
蔡心耜	人物
鲍昌	散文家
解峰	实业家
虞光裕	名人
雷雨顺	陕西人
雷烽	陕西人
蒲保明	社会
楼海日	科学家
谢新颖	河北人
谢道渊	名人
谢晶曦	人物
谢绪恺	科学家
谢高觉	人物
谢克西	人物
谢永旺	文学家
谢凡	人物
曾鼎乾	人物
曾荣华	人物
曾性初	湖南人
童诗白	人物
童世璜	学者
程季华	湖北人
程其襄	科学家
程华青	江苏人
程坦	主持人
傅锡寿	名人
傅忠海	政治家
鲁明	外交家
舒炜光	学者
舒光冀	名人
景德敏	政治家
景德敏	人物
彭静山	辽宁人
彭坤墀	科学家
赵志宏	山西人
赵守义	山西人
赵光贤	北京师范大学
赵以炳	科学
赵公达	山西人
赵干卿	政治家
胡景儒	陕西人
胡绩伟	四川人
胡迪鹤	湖南人
胡必烈	湖北人
胡汉泉	江苏人
胡汉泉	科学
胡立教	政治家
胡石言	艺术家
胡子婴	浙江人
胡子婴	上海
郝秀山	政治家
项志遴	科学家
项南	人物
孟贵彬	河北人
孟尔盛	学者
孟英	天津人
古谷实	机器猫
中论	宗教
吴贻弓	导演
温盘峪	风景名胜
投资率	术语
斯普利特	克罗地亚
斯普利特	文化
周彦生	专家
钮制	印章
青娱乐	互联网
张结	名人
娱心悦目	文化
语言无味	文化
抽油烟机	生活用品
据悉	汉英词典
过兴先	名人
争宠	喜剧片
白茜	官员
卢之超	宝应
王品素	声乐
洪青	建筑师
范济洲	名人
范子文	陕西人
冯国旺	人物
构造运动	地质
温室效应	物理化学
夏尔丹	油画家
卢庆骏	教授
苋	植物药
蔺柳杞	山东人
相干光	自然科学
安志文	人物
乔培新	人物
袁廉民	摄影师
宋长志	辽宁
贾石	人物
李月辉	官员
常秋英	名人
后尘	词语
黄蕴慧	科学家
康矛召	战地记者
啜英咀华	文学
奋袂	词语
林修德	人物
等积投影	自然科学
革旧从新	成语词典
鹯	字典
鹯	词汇
巨峰镇	乡镇
樤	汉语
现金管理	国际金融
火龙果	饮食
主合同	社会
张文渔	配音演员
卢琨	配音员
瀹	字典
柏安妮	人物
单立文	香港
林蛟	艺人
四则	词典
趑趄	词语
氩弧焊	汽车
小人物	人物
通幽汤	汤剂
阎世善	艺术家
窦蔻	著名作家
调速器	机械零件
崔炳文	劳动模范
秦茂轩	人物
询	词汇
屋	汉字
婉	文字
嗣	文化
体	济宁市
突	人物
圮	文化
垣	汉字
延	人物
纂	汉字
皱	汉字
刑履祥	新文化运动
萧永正	军事家
创造性	法律
偷	词汇
培	汉字
旋	文字
悬	文字
述	文字
榻	文化
啮	汉字
跣	文化
遵	居家
故事片	艺术
解土	汉语
丰土	词汇
输血	生理学
日心说	哲学
规矩钩绳	文学
根据盘互	成语
毒物学	生物化学
夷平面	地球科学
憻	汉语
朣	汉字
武迹沧	革命烈士
古今中外	语言
孤军作战	语言
鬼哭狼嗥	词汇
幅度	词语
透雕	珠宝
孙普协	川剧
汇丰银行	金融
龟龄鹤算	国学
膏粱锦绣	词汇
娄山站	车站
税种	经济法
明石海峡大桥	日本
龙门桥	洛阳
灵隐寺	寺庙
宗教改革	文化
干名采誉	语言
满剌加	明朝
文澜阁	园林
鬼魅伎俩	文学
鸭脖子	武汉
罗亚尔港	地区
相变	微电子学
商务	生活
简单劳动	经济
逍遥自在	文化
布衣韦带	国学
朱诚淋	明朝
朱弼桄	历史
唐浩明	文学
佝偻	词典
议案	政治
地下开采	矿物
黄平县	旅游
辛追	女性
西清桥	建筑
默不作声	成语
贡菜	自然
诛求无厌	典故
诛求无厌	文化
祖辛	商朝
转败为胜	成语
筑舍道傍	成语
胡兴楷	济南人
侯筱章	革命烈士
陈宇凡	影视
重规叠矩	文学
中流一壶	成语词典
皮儿薄	表演
应天顺人	国学
周怀清	阿訇
改名易姓	成语
时气	病症
时候	词典
甘贫守分	词汇
归全反真	词汇
光前启后	词汇
苟且偷安	文化
高情逸态	国学
高情逸态	语言
骨软肉酥	词汇
骨肉团圆	文学
感人心脾	国学
高人一筹	文学
司马朗	三国
寡人之疾	语言
改是成非	国学
根深柢固	成语词典
悯时病俗	成语词典
电子流	物理学
各色名样	国学
于庆玉	人物
马金镖	人物
鱼精	生物学
放诞不拘	国学
锋芒所向	文化
抚世酬物	语言
凤髓龙肝	成语
福寿双全	文化
吴鉴泉	中国武术
风雨连床	成语
凤翥鸾翔	国学
盖世之才	文化
国无二君	文学
告往知来	文化
斯巴鲁	交通
刚中柔外	成语
换斗移星	成语
临池	书法
龙楼凤阁	文学
龙楼凤池	成语
龙楼凤池	国学
龙章凤彩	语言
莫梅德	神话
项城	袁世凯
王兴南	名人
王大彤	人物
嫠不恤纬	语言
马克林	甘肃
关山迢递	语言
砖头	应用科学
云悲海思	文学
居民点	汉语
安福县	江西
管孔藻	藻类
静脉	人体
衢江区	衢州
意气用事	成语
黄斑	应用科学
经部	词汇
经部	词典
癌变	病理学
癌变	生活
蔼蔼	树木
蔼然	词汇
目酣神醉	成语
麦绍棠	港台明星
耿新伟	新疆
喷射机	水族
抵瑕陷厄	成语词典
党邪陷正	文化
惊慌	词语
红丁香	水族
烧火棍	东北
道在屎溺	语言
倚门卖俏	成语词典
膂	字典
高氯酸	无机酸
混合税	对外贸易
宝腾	交通
公畜	词汇
慧根	宗教
石海椒	花卉
衣衫褴褛	俗语
麦杆菊	生物
繁文末节	文学
风行电照	成语词典
汉寿县	常德
荡涤	国学
参商之虞	汉语
参商之虞	词语
结古镇	地理
鬼头滑脑	语言
描述统计	心理学
人神共嫉	语言
刃树剑山	汉语
人神同嫉	语言
狗偷鼠窃	成语
甘棠之爱	词汇
常素庙	风景名胜
如汤泼雪	典故
忍心害理	文学
符敦秀	人物
日省月试	文学
认影迷头	国学
日月逾迈	词汇
张启良	军事家
王骏超	名人
水碧山青	词汇
水碧山青	文化
撺掇	词汇
一门心思	语言
假性近视	医学
红海湾	自然保护区
一笔抹煞	国学
一笔抹煞	文化
弃若敝屣	语言
托举	运动
燕巢于幕	国学
耳痛	应用科学
揎拳掳袖	成语词典
刘再复	艺术
萧思温	辽代
卡迪西	人物
敉	字典
匍	字典
生物转化	循环
汉长城	长城
碳素纤维	体育
碳素纤维	体育设施
鱼尾	印刷
赵丁夫	山东
刘光桐	军事家
仲成	山东
胡允恭	历史
张绍刚	播音员
哈拉哈河	兴安盟
黄世长	国学
贝伟生	革命烈士
黄绪晏	人物
霍友祖	革命烈士
日许时间	语言
日中将昃	语言
如醉如狂	词汇
如左右手	语言
如指诸掌	词汇
食不充口	语言
剥蚀	书法
一己之私	文化
研经铸史	词汇
语近指远	国学
哑口无声	典故
胡蓓蔚	明星
饮露餐风	成语
护眼	医学
江蕙	歌手
泡泡网	互联网
低等植物	高等植物
碘酊	医药
阿魏酸	药品
诸葛丰	西汉
娄烦县	乡镇
泰然	科学
古巴共产党	共产党
母法	社会
巴根汝	书法
叶国祥	书法
仪狄	历史
地温	电力
地温	天气
词干	科学
丁永纲	将军
一晦一明	语言
烟聚波属	文学
岩居川观	词汇
岩居川观	文化
云集景附	词汇
应机立断	文学
运蹇时乖	语言
衣锦食肉	成语
衣锦食肉	语言
保存	科学
一面之词	成语词典
鱼米之地	文学
喃喃细语	成语词典
盐梅舟楫	成语
一面之款	国学
一面之款	语言
阴凝坚冰	成语
因难见巧	成语
逾年历岁	词汇
远年近岁	文学
夕惕朝乾	词汇
学无常师	国学
续鹜短鹤	文化
巢倾卵破	典故
银屏金屋	汉语
纡佩金紫	文化
西方净土	解释
席丰履厚	语言
赫柏	神话传说
袭故蹈常	成语
科兹洛夫	人物
参政	政治
凤藻	词汇
凤藻	汉语
辞严谊正	文化
数位	科学
程彪	人物
康启华	革命家
马友才	人物
秋成勋	人物
康恩	体育人物
桂花树	植物
刘湘屏	名人
陈泳炎	艺术家
嚮	文化
波浪	文学
波浪	自然科学
李隆兴	人物
龙金书	湖南
徐宝梯	作家
武承嗣	人物
庞师古	将领
蜂屯蚁杂	语言
飞土逐肉	语言
法无二门	成语
福无双至	语言
天象	词汇
拜科努尔航天中心	航天
凌空	汉语
崦	汉字
荣禄宅	建筑
普胜寺	寺院
乐善堂	慈善机构
缏	文字
缏	字典
大隆镇	广西
合金弹头	单机游戏
茝	语言
云迷雾罩	词汇
舞弄文墨	文化
倏	语言
授柄于人	词汇
山塘	地名
表决权	社会
吴暾	人物
米伦	人物
韔	汉字
灰土	汉语
凤栖山	风景名胜
池八妹	革命烈士
澌	字典
澌	文化
椎心泣血	语言
眙	字典
痦	汉字
痦	汉语
出差	词典
李兆权	人物
水煎包	生活
统统	汉语
归心如箭	文学
牛存节	山东
才过屈宋	熟语
张居翰	历史
冯行袭	唐朝
riff	文件格式
裱画	书画
慕林杉	名人
侯丰	名人
王筱磊	主持人
薄壁组织	生物工程
肖薇	中央电视台
叶迎春	央视
担子	自然科学
顶极群落	高新技术
毕铭鑫	名人
分蘖	应用科学
分析器	机械工程
分析器	科学
缝隙连接	生物学
斯民三	人物
阳茎	自然科学
触角	古生物学
爪牙	文化
爱昵	语言
丁赋	经济
除法	术语
阎青妤	山东
练惕生	福建
王云九	青岛人
金洲小学	小学
憃	文化
摴	文字
膪	文字
鰆	文化
辵	语言
辍	汉字
梢	汉字
马嚼子	惯用语
幼儿	生活
打落水狗	文化
藏污纳垢	成语
大肚子	解释
屠龙之技	语言
柴油发动机	机械
菆	汉字
夎	文字
老哈河	地理
买菜求益	文化
砀	语言
髢	文字
蹢	文化
魔铃	圣斗士
蹛	汉字
安郁平	新疆
贺娄子干	北周
罗织构陷	成语
民法典	法律
乙酸	科学
河中	元朝
施济美	浙江
黄观顺	名人
陈安芳	上海
黄君珏	人物
太安鱼	潼南
铁公祠	济南
甘言厚礼	成语
甘言厚礼	文化
甘言厚礼	语言
天圆地方	技术
沽誉买直	语言
桑辛素	中草药
唗	文字
陈建州	主持人
许永生	人物
赵成宇	演员
土壤细流	国学
曹家鼎	人物
淫	佛教
氤	汉语
央	汉语
阋	汉字
莫家拳	中国武术
万尾金滩	风景
谷秀荣	名人
涘	语言
衤	汉语
海峡交流基金会	基金会
勚	文化
勚	词汇
益气	应用科学
天河城	商业
rootkit	木马
田豫	三国
爱尔兰语	文化
霞帔	服饰
朏	字典
俛	字典
天之戮民	文字
陈传海	教授
韦岛	印度尼西亚
韦索	城市
佐剂	自然科学
固化剂	化工
母权制	氏族
騧	语言文字
鬶	文化
黑莲灯	热带鱼
陈球德	教师
独山县	中华人民共和国
耆	汉语
纲领	战术
剑锋	艺术
瓦杜兹	首都
语默	诗歌
谋	汉字
揈	文字
蔧	语言
謋	文化
凝析气	石油工业
齿	机械零件
细大不捐	文化
黛丝	卡通人物
垍	语言
穊	文字
白沙烟	居家
扇形	图形
大城县	河北
名存实亡	词汇
林金泉	官员
天地剖判	汉语
天夺之魄	成语
天壤王郎	成语词典
仇祯祥	人物
戴戈	沈阳
呼呼	人物
胨	分子生物学
箜	文字
丰狄	饮食
微	理论物理
潍	字典
坚如磐石	成语
葳	汉字
玮	汉字
送	文化
耸	汉字
悚	汉字
忪	字典
聊且	汉英词典
蚯	字典
蚯	文字
丿	汉字
瞢	词汇
乕	生僻字
艨	汉字
弄	名词
骄傲自满	语言
株	文字
翥	汉语
跔	字典
蓐	汉字
蓐	词汇
濡	汉语
乼	文化
经济作物	经济
校长	历史
物资	经济
库房	贸易
雁宾	词语
点名	汉语
沙可	科学家
三跪九叩	成语词典
省军区	军事
水芙蓉	自然科学
张大方	人物
徵	古典音乐
袴	服饰
狯	汉字
纩	语言
冯钧	人物
宜兰县	台湾
颇	字典
耦	字典
无锡站	无锡
压花	艺术
敏感期	心理学
徕	语言
金钏儿	文物
连秀峰	医生
盭	文字
蒙古语	古籍
转矩	机械工程
光刻	微电子学
线宽	科学
阿依古丽	歌剧
大写	汉字
大杂院	建筑
姬路城	文化遗产
龚绍东	江苏
朱用纯	名人
顾绶康	浙江
管震湖	人物
吉皮乌斯	女诗人
速效救心丸	科学
多菌灵	园艺
胗	语言
除草醚	园艺
都尔	科学
龙涎香	科学
特里普拉	印度
谱	物理学
迎角	飞机
舲	文化
李天雄	文学家
连维良	公务员
太美丽	音乐
纑	汉字
纑	服装
荦	字典
落果	农林
鑢	文字
圙	汉字
鼚	汉语
駹	文字
邿	汉字
筮	字典
肄	文字
縻	语言
三川	体育人物
林白薇	作家
怀圣寺	地理
绫波丽	eva
陈鸣树	文学
方孜行	文学家
刘智业	作家
彭名燕	名人
晰	字典
烯烃	有机化学
唏	词汇
禊	汉字
吗啡中毒	科学
皙	汉语
蜥	词汇
蟋	字典
舄	词典
舄	服饰
腊	佛教
笢	语言
暋	语言
郭泰	东汉
纆	字典
内藏寺	生活
明目	应用科学
攮	汉字
尼雷尔	坦桑尼亚
斯奇丹	地理
专	文学
恶意软件	危害
制动	词语
结肠炎	药品
蒲鞭示辱	语言
掊斗折衡	词汇
剖玄析微	语言
渑池之功	成语
负重涉远	语言
法家拂士	成语词典
下乔迁谷	成语
武庚	西周
武庚	国王
冯金堂	中国作家协会
刘耕夫	人物
副翼	飞机
半潜船	京沪线
鲁特琴	艺术
营销学	开放
泡	科学
王革勋	党员
史培德	共产党
岐阜县	日本
奉命惟谨	成语
奋身不顾	词汇
奅	字典
鎞	汉字
向火乞儿	文化
貔	汉语
七彩	经济
晨提夕命	成语
孔庆全	人物
孔庆全	学者
谢寿康	经济学
东大街	历史
张舫	历史
黄学增	遂溪
塞内卡	美术
井研	四川
鏺	文字
1000	数学
慼	语言
踦	汉字
褰	汉字
劁	语言
幧	字典
肖德秀	山东
梫	汉语
謦	语言
担负	词语
白马石	旅游
枝角类	自然
李宗山	淄博
陈泗才	人物
栾鸣岗	历史
李栋基	中国
44	数字
曹钟书	人物
瀼	语言
穰	语言
塔斯马尼亚州	澳大利亚
纴	语言
谢润良	文学家
徐小斌	电视
昌黎镇	地理
德庆县	地理
李启汉	革命烈士
北纬	风
去极化	神经系统
玉紫岩	山
顋	语言
膻	字典
鐥	汉字
拔新领异	成语
广钦	人物
无冬历夏	文化
然糠自照	文化
成城断金	语言
plugin	计算机
圆锥曲线	解析几何
乔文猊	名人
季红真	学者
邓倬明	文学家
丁国成	理论
万伯翱	文学
万忆萱	文学
安德馨	人物
于纯厚	人物
于炳坤	名人
子页	文学家
壬酸	自然科学
草鱼	鲤科
吉冈美穗	演员
林思显	名人
蔬	文字
一斑半点	文化
一表人物	成语
一病不起	熟语
普拉希尔	足球
飕	汉字
测谎仪	设备
谡	汉字
笑翠鸟	鸟纲
裘琏	清代
西曼	体育
小昭寺	旅游
法式	词典
杨慎	四川人
马开尧	名人
顾学颉	名人
王充闾	辽宁人
王长军	作家
冯宝宝	香港
梁英瑞	烈士
斿	汉语
鬼针草	中药
鬼针草	应用科学
鬼针草	植物
七上八落	文学
人间天上	文化
大头小尾	成语
叶柄	艺术
千古独步	成语
千红万紫	文化
千里姻缘一线牵	熟语
千载一圣	语言
柱头	生物
韩民堂	教授
夏张镇	泰安
波斯顿	香水
土崩鱼烂	成语
亡国之器	文学
小脚女人	俗语
车填马隘	文化
尺二冤家	成语
斗艳争芳	文化
硕果仅存	成语词典
硕果仅存	语言
计功行赏	词典
开来继往	词语
牛黄狗宝	语言
切理厌心	文化
日久见人心	词汇
双宿双飞	语言
水尽鹅飞	语言
水穷山尽	词汇
水宿风餐	词典
太平无象	汉语
天成地平	词汇
天年不齐	语言
文山会海	文学
乌天黑地	文化
无洞掘蟹	成语
无如之何	汉语
无为之治	政治
侯焕格	河北
以半击倍	词语
以古为鉴	语文
以古制今	词典
引新吐故	典故
云梦闲情	成语
云迷雾锁	文学
英招	天龙八部
出一头地	语言
打家截道	词汇
打情骂趣	汉语
大宁县	地域
东游西荡	语言
泽州县	地名
纪子瑞	历史
龙断之登	词汇
民生国计	词语
目不忍视	成语
目光如鼠	词汇
目无三尺	文学
目知眼见	语言
生关死劫	词汇
生寄死归	词典
四海皆兄弟	成语
未足轻重	文化
玉宇琼楼	词典
潠	文字
山本耀司	地理
北京市广渠门中学	社会
臣心如水	语言
成群结队	成语
驰志伊吾	词语
从容就义	词典
当立之年	词语
地负海涵	语言
多此一举	词语
回光返照	佛教
交相辉映	成语
权移马鹿	文化
如法炮制	语言
如埙如篪	文化
收成弃败	语言
同生共死	语言
同休共戚	成语
同休共戚	典故
扬扬自得	成语
因乌及屋	熟语
有眼无珠	成语
众毁销骨	文化
杜渐防萌	词语
杜门不出	词汇
杜门不出	词典
杜门自绝	词汇
进退荣辱	成语
李郭同舟	成语
麦秀两歧	成语
没毛大虫	词语
日月经天	语言
穷山僻壤	成语
璕	中华文化
束带结发	语言
束身自修	语言
束手坐视	词语
束手坐视	典故
体物缘情	成语
听风听水	典故
花蔺科	生物
知遇	词语
闲言碎语	词语
言犹在耳	文化
应答如响	词典
应答如响	文学
杞天之虑	词典
泥而不滓	词汇
披星带月	成语
青龙金匮	词语
拈酸泼醋	成语
其应如响	典故
软裘快马	词语
鱼龙混杂	词语
岩居穴处	词汇
刳胎焚夭	词语
彗尾	物理学
昌亭之客	成语
俛拾仰取	成语
百思买	家用电器
独木难支	成语
炊粱跨卫	语言
楼盘	生活
分茅锡土	词典
发怒冲冠	词典
洛阳市	商丘
虚无飘渺	语言
王叔铭	山东人
柳腰花态	词汇
架海金梁	俗语
柔情绰态	语言
柔肤弱体	成语
蝶骨	解剖学
寇加尔	魔兽争霸
阗	字典
餂	汉字
橦	解释
恸	汉字
漙	语言
漙	字典
捝	文字
西安市公安局	西安
隆山塔	文物
涕泗横流	词语
艾莉瑞亚	dota
北白象镇	乐清
塘下镇	浙江
潘玉书	名人
丁炳权	英雄
范汉杰	广东
许镇镇	芜湖
辋	汉字
郭宝兰	河北
中岩	旅游
马提尼克岛	岛屿
珀斯	地名
朱维铮	语言学
大伙	口语
咳唾成珠	词汇
眉高眼低	语言
品竹调弦	语言
南山铁案	词汇
荣宗耀祖	文化
顺风使帆	词语
俗不可医	文化
突然袭击	文化
说地谈天	词典
养虎伤身	语言
陈保中	社会
浃髓沦肌	文化
柚子茶	健康
夜不能寐	医学
夜不能寐	词语
知识窗	杂志
烈烈轰轰	词语
流汗浃背	语言
热气腾腾	典故
辱门败户	词语
破斧缺斨	语言
破铜烂铁	美国
桃花人面	文化
鸱视狼顾	语文
金台市骏	词汇
经纶满腹	成语
空腹便便	成语
甬	汉字
戴菊	鸣禽
素面朝天	典故
赵会仪	文学家
精贯白日	成语
宇堂	作家
潘乃德	人物
词性	文学
错开	词汇
网速	手机
卡拉克	城镇
盐源县	地理
倩人捉刀	语言
味如鸡肋	字典
味如鸡肋	文化
桃红柳绿	花卉
济苦怜贫	成语
匡时济俗	文化
匡时济俗	语文
磕头如捣	语言
复种指数	农业
忤	字典
妩	汉字
肸	文字
潝	汉字
鸡鹜争食	语言
安美汀	医药
痴儿呆女	词典
痴儿呆女	语言
赩	字典
潟	字典
昆弟之好	典故
矿藏	环境
孝子顺孙	成语
里德伯	人物
卖剑买牛	典故
襐	文化
篠	文化
调停	词汇
票据法	社会
牟汉华	山东
王老黑	名人
郑云云	陶瓷
抗税	财务会计
满山岛	景点
聊	汉字
迁	解释
衺	字典
渫	语言
獬	汉字
囟	汉字
钘	字典
开疆拓境	语言
窥见一斑	语文
沃	中国联通
匡时济世	成语
亢极之悔	成语
亢极之悔	周易
埳井之蛙	词典
岁月蹉跎	文化
慷慨激扬	典故
心直口快	熟语
苦乐不均	典故
恟	文字
魆	字典
繻	语言
镯	词汇
何本立	清代
缒	汉语
卮	汉字
烜	汉字
可视电话	电子技术
巴拿马城	文化
桢	文化
棪	文字
扊	文字
声呐	科学技术
李波儿	主持人
立言	词语
墕	字典
瀁	中华文化
轺	文字
肇	文化
涢	汉字
贠	文化
贠	汉语
钙化	科学
青菜	十字花科
激光照排机	信息技术
钛	科学
黑油椿	自然
绿岭	水果
庆丰	生物
海芋属	盆栽
哈伦	城市
大果杏	生物
布莱特	落叶果树
红宝玉	落叶果树
黄杏秀	人物
香珊瑚	果树
伏里红	生物
秦美	生物
秦美	落叶果树
特哈玛	生物
曳	字典
意懒心灰	文化
嫛	字典
峄	语言
热管	传热学
膺	汉字
圄	文字
瘐	汉字
符启林	法律
博学	词语
博学	国学
椎髻布衣	词典
炒冷饭	词语
七夕节	情人节
袁甲三	人物
薛焕	四川人
杨坊	人物
托明阿	满洲
汶川县	县
好歹	汉语
谢唯俊	烈士
谢唯俊	人物
称心满意	文字
无力	词典
无力	应用科学
逞心如意	成语
辞不达意	语言
工程技术	科学技术
阈	字典
谕	文字
蓣	汉字
薁	汉字
宇治	生活
宇治	旅游
林披	诗人
白语	文化
衢	文字
粉红噪声	应用科学
粉红噪声	科学
褚宸舸	法学家
席宝田	湖南
检举	法治
富明阿	清代
袁世敦	人物
怆	字典
踔	文字
苁	解释
霍存福	吉林大学
贪墨成风	词语
感戴二天	文化
形只影单	文化
邅	汉字
浅蓝	网站
椥	字典
铚	语言
猘	汉语
疐	汉字
鱼眼石	地质学
袾	语言
髽	文字
籑	汉字
王炳根	人物
王泮文	山东
王维洲	人物
王淑耘	中国
王精忠	文学
神秀	术语
擦拳磨掌	文化
财迷心窍	典故
才疏德薄	文学
才华超众	语言
才貌双绝	文化
昌溪	历史
鼠胆	中药
风清扬	人物
愚夫蠢妇	语言
言发祸随	语言
烟霏雾集	成语词典
赵尔丰	清朝
水窖	汉语
张佑赫	舞蹈
行波管	射频
雍国	古国
衣向东	名人
衣向东	中国
弗氏灵芝	真菌
气海穴	应用科学
阴维脉	穴位
潈	汉字
捽	语言
怡然自得	解词
坐	宗教
胡延照	政治
上气不接下气	词典
水师	汉字
立方米	数学
立功赎罪	词语
侑	语言
裕	字典
发射机	电脑
逞娇呈美	成语
百念皆灰	文化
麇骇雉伏	成语
贫困潦倒	文化
杨德然	名人
李长瑞	名人
王兴周	人物
宋建谋	人物
舒雨旺	人物
牛磺酸	中成药
蚕丛鸟道	语言
邓攸	大臣
炑	汉字
炂	文化
曹薰铉	围棋
餐霞饮液	文学
烐	历史
餐松啖柏	词典
餐松啖柏	成语词典
焫	历史
焂	汉字
焸	中国
忧患	解释
大椎穴	人体
煓	中国
美餐	汉字
美餐	词典
天突	针灸学
管叔	大臣
宋襄公	人物
荀林父	春秋
国际电信联盟	通信
阳虎	围棋
游吉	郑国
叶倾城	文学家
中央编译出版社	传媒
邓普	文学家
车吉心	文学
邓荫柯	中国
韦野	作家
东生	人物
鲍化普	中国
銐	中国
石斑木	自然
丰厚	汉字
惹	字典
谭栖伟	官员
艳装	汉语
归罪	词语
果子酱	汉语
李容根	广东
冰坝	电力
朗池镇	地理
失口	汉语
博世	德国
净水器	家电
李妍霏	戏曲
锣经	京剧
屠戮	文学
硫氰酸钾	钾盐
实名制	网络
策名就列	文学
赶工	汉字
赶走	汉语
越冬作物	词语
越权	古文
即刻	词典
眼巴巴	汉字
周柏森	法学
眼花	词典
装束	汉字
清风劲节	汉字
拿大顶	北京话
班达拉奈克	人物
戴高帽	文学
石镇镇	地理
孙宪忠	民法
祖庚	帝王
方鼎英	湖南人
国富民丰	成语词典
公而忘私	文化
永泰县	行政区
功成行满	语言
平西将军	官职
辜负	词汇
汽缸	汉字
緂	解释
刘子光	名人
貚	文字
譠	文化
莲花水电站	建筑物
行不副言	词典
确认书	社会
象山区	地名
雁山区	行政区域
尼特拉	斯洛伐克
青秀区	地理
柳北区	柳州
融水苗族自治县	广西
恭城瑶族自治县	地理
王泗镇	乡镇
靖志远	人物
彭小枫	人物
身亡	词语
魏碑	文字
文化层	历史
铜	自然科学
月虹	自然现象
戴煌	文学家
语短情长	文化
乘顺水船	文化
暗淡	形容词
惊皇失措	汉语
暗沟	建筑材料
逞奇眩异	词语
惊涛怒浪	熟语
惊心眩目	熟语
惊愚骇俗	熟语
鬤	汉字
饡	汉字
廖中洪	教授
地址映射	科学
枞阳县	中国
十分	汉语
replay	歌曲
搜索引擎	信息
网络拓扑	能源科学
曹成模	明星
夏麒祥	中国
宗芸	中国
冯剑华	名人
加里	人物
冲冠发怒	词汇
充饥画饼	文学
宠柳娇花	文学
除患兴利	文学
传为笑谈	文学
拐子	词语
怆天呼地	文化
捶床捣枕	词语
垂饵虎口	成语
无恶不造	语言
无计可奈	熟语
国中	初中
泽比纳	球员
书佐	官职
豪门巨室	成语
暗室	汉语
暗喜	词语
黯然	形容词
昂贵	价格
陈翠贞	人物
徐丰彦	应用科学
新野县	旅游
岑公祠	旅游
茅侃侃	创业
望花区	地理
黄岛区	青岛
武侯区	四川省
盐边县	地理
第一	物理学
each	程序语言
布海站	车站
聚丙烯	化学
聚氯乙烯	有机化学
唐昧	历史
包忠文	人物
卢振中	作家
卢江林	人物
卢江林	中国
古笛	南宁
鼓角	中国
史光柱	人物
匡韶	人物
叶孝慎	名人
吴金良	中国
桃腮粉脸	成语
桀骜难驯	词语
梧桐断角	成语
梳妆打扮	词汇
此风不可长	语言
梯愚入圣	成语
聪明智慧	语言
河升镇	体育人物
椒焚桂折	成语
寸善片长	典故
极本穷源	汉语
极往知来	文化
韦树模	人物
楚文王	人物
白龙亭	人物
靶场	词汇
钟绅	三国
瘠牛羸豚	语言
娃	汉字
纽约时报	新闻媒体
瓦祖站	车站
合纵	词汇
国法	汉语
发火	词典
曹逢时	南宋
径流系数	科学
望牛墩镇	广东
空中加油	军事
钛	科学
夹层	自然科学
白搭	汉语
諥	汉语
潘维周	名人
江继复	孙中山
方声涛	国民党
秦氏楼	典故
烤饼	美食
中国城市环境卫生协会	协会
腾空	体育
翸	中文
曹玉海	烈士
曹玉海	博士
音像制品	影音
任渭川	人物
曾超	专家
楚威王	君主
太乙洞	地理
汀泗桥	景点
十滴水	中医药学
老大哥	seo
gonna	俚语
盖楼	建筑
瓶胆	名词
房玄龄	历史
光学录音	音像
光学录音	光学
冧	字典
转语	词语
板滞	文字
低人一等	成语
左介贻	人物
左建明	人物
左云林	文学家
传入神经	生物学
传出神经	自然科学
贪财好色	词汇
贪色	词汇
封官许愿	成语
邓晨	东汉
朱溥钧	名人
甘铁生	诗人
甘竞存	文学家
甘竞存	中国
甘竞	文学家
紫峰	名人
汪浙成	文学家
纵隔	生理
米盐博辩	词典
齩	汉字
镂骨铭心	俗语
梦想颠倒	成语
寿百年	品牌
蒋翊武	革命家
蒋国涛	民国
三五	词典
登机牌	交通
屠伯	人物
羯羊	自然
热值	能源
核工程	专业
析木	地理
插画	艺术设计
碰钉子	文化
江万里	宋朝
赛典赤	历史
舒茶镇	地理
杨树山	漫画家
示人	词语
慎云贞	作家
雨苗	名人
邢人杰	文化
信宿	古文
北卡罗来纳州	地理
刘炫	人物
缩略语	词典
遗忘曲线	社会科学
文山壮族苗族自治州	云南
玄酒瓠脯	成语词典
李国彝	人物
8毫米	娱乐
牌	语文
社会民主党	知识
卡尔斯鲁厄	德国
国际禁毒日	纪念日
赵锡光	新疆生产建设兵团
郭方预	农民起义
唐寓之	人物
戈矛	作家
吴洪源	北京
吴海民	文学家
吴源植	文学
雪宇	作家
戴富	文学
乔官镇	乡村
北岩镇	乡镇
闄	词汇
闄	语言
蘨	词汇
袎	词典
好像	词语
技术员	职业
小己得失	成语
小家子气	俗语
中位沼泽	地理
高位沼泽	生物化学
结构设计	建筑工程
苏笛	文化
国八条	热点新闻
助动词	科学
西化	生活
陈振先	烈士
陈淑秀	文人
桍	汉语
志愿	词语
临湘	地理
东干语	吉尔吉斯斯坦
邓玉麟	辛亥革命
孙天放	人物
药剂师	医药
赵蕴玉	艺术
人体摄影	艺术
射影	投影
夏溪镇	江苏
红薯	药品
沙士	饮料
燕尾鸥	鸟类
张谠	名人
新井里美	cv
输入阻抗	电子
糊里糊涂	语文
巴青县	民族
洛扎县	西藏
付家镇	辽宁
秦妇吟	韦庄
随人作计	成语
张兆丰	人物
外学	文化
邱振亮	人物
和平县	河源
佳士得	经济
吴禄贞	汉族
古格	历史
食日万钱	词语
旌旗蔽空	成语
网络理论	物理学
劳厄	物理学家
营盘	地名
何乐	作家
可要	词汇
宋清海	名人
抹不开	词语
张雷激	文学
交通地图	地图
襄渝线	铁路
阿越	小说家
睾丸素	男性
寿鱼科	生物
清定法师	宗教
国树	应用科学
华南地区	行政区域
大汶河	旅游
次氯酸钙	医学
皂君庙	生活
张燕瑾	人物
剧组	剧本
文情	作家
阿鲁科尔沁旗	资源
流派	音乐学
ewr	资料
斯柯达	生活
流里流气	成语
遗觉象	现象
乌兰浩特	地理
梁师成	明朝
文定皇后	朝鲜
鳞翅	生物
precious	音乐
含垢忍辱	文化
文源阁	文物古迹
吉萨	运动员
夜礼服	生活
李奎才	作家
水北	名人
齐瑶	作家
刘清莲	人物
宇父	名人
蕨类	古生代
挥发性	药品
步人甲	宋朝
鄂尔多斯高原	内蒙古
妩媚	小说
哈斯兰	足球
阿伦河	水体
阿伦河	自然地理
楷书	汉字
籽粒苋	自然
套耕	农作物
英飞凌	公司
宋希	运动员
穆如清风	成语
暮雨朝云	语言
暮夜无知	成语
书院门	西安
鸾音鹤信	汉语
鸾鸣凤奏	成语
鸾歌凤吹	成语
吕安题凤	俗语
闾阎安堵	词语
麟角凤毛	文化
磊落豪横	词语
渔翁之利	词典
鱼水相欢	俗语
鱼水深情	文化
鱼龙漫衍	成语
鱼龙曼羡	词语
鱼烂取亡	成语
燕昭市骏	词典
燕巢幙上	汉语
秋琳	主持人
叕	多音字
单卫国	篮球
抛物面镜	自然科学
掺杂	化工
掺杂	自然科学
鲁芬	明星
苑琼丹	亚洲电视
须弥芥子	文化
印加宝藏	外国文学
板鞋	生活
汪永江	人物
虚实	围棋
厚	字典
强敌	艺术
巴林第纳尔	巴林
筛	词汇
途	汉字
斑纹	美容
奇观	地理
联结	生理学
麻酥饼	饮食
推而广之	成语
藤本让	声优
舆论监督	新闻
演说	语文
巴丹杏	特色
塞布河	水文
菌类	自然
塞格德	地理
类毒素	医学
犹太民族	犹太
保险粉	营养学
弗兰科	足球
措勤	地理
明孝陵	陵墓
格拉泽	学者
毛霉	科学
音节文字	科学
高凉	县
松陵镇	旅游
资本集中	社会
私家菜	特色
洞门	轨道交通
卢作霖	武侠
安杰尔	建筑
舒降之	疾病
美解眠	药理学
美舒宁	医学
氨甲蝶呤	科学
更生霉素	分子生物学
零号	阿拉伯
亚维农	宗教
黄秀贞	明星
林之	作家
刘小湄	文学家
刘子成	名人
文南	文学家
文南	名人
教与学	心理学
克亚克	音乐
朱之锡	名人
武汉钢铁股份有限公司	上市公司
阿昌语	文化
橡皮泥	儿童
骨髓灰质炎	科学
翠园	买房
体节	自然科学
逍遥镇	河南
酒食征逐	文学
粉丝网	站点
分明	词典
眼明手快	成语
诌上抑下	成语词典
中博会	贸易
历历在耳	文化
四角俱全	成语
相煎太急	成语
缠绕	汉语
非常家庭	漫画
鼋	爬行纲
延禧宫	故宫
黑三棱	科学
欧意	科学
高小方	教授
马俊山	人物
时期	汉语
时期	天文学
潘玮柏	男演员
香莳萝	自然
宝玑	艺术
刘发俊	文学家
林伟贤	培训师
犀牛皮	中药
叓	汉字
龚橙	历史
金田一一	人物
中国书画函授大学	文化
透视缩影	词语
白云母	染织
独特型	科学
梅河口站	吉林
谢雪心	表演艺术
内膜	植物学
结拜	文化
波格森	科学家
隐身人	言情小说
望屋而食	语言
正压	通风
李旦初	文学
李永鸿	实业家
左轮手枪	轻武器
循环风	通风
拉瑟弗德	天文学家
覃锡之	文学家
阳云	文学
通江桥	地名
祖庙巷	地理
甘泽坊	地名
肖开愚	人物
井亭桥	建筑
独资企业	法律
杨步亭	人物
崔知悌	科学家
武都郡	地名
昌黎郡	历史
昌黎郡	地名
南郡	地名
杨绵绵	领导
贝州	地名
长洲苑	地名
李诗韵	明星
苑川	历史
伍咏薇	tvb
伍咏薇	歌手
齐振铎	散文家
齐克	作家
严昭柱	名人
严敦易	人物
赫裕昆	作家
何顿	文学
何玉湖	作家
备付金	生活
尘肺病	公共卫生
沈璎璎	文学
光球	自然科学
∫	符号
副油箱	航空
石油化学	石油工业
光鱼	生物
正己烷	自然科学
裨益	词语
独流镇	地理
独流镇	静海
华芳	张家港
西山饿夫	文学
手法	词汇
惹祸招殃	词语
辱国殃民	词语
蠹国殃民	语言
林志山	文学家
季泉	文学家
佘树森	名人
杨采妮	明星
塞奇	科学
蓬斯	人物
球茎甘蓝	食品
贝托莱	人物
大钟寺	建筑
程师孟	北宋
听证	政治
相忘形骸	词语
绳厥祖武	成语
夷然自若	语言
潜心笃志	成语
笃论高言	成语
有机酸	科学
跅幪不羁	语言
钻穴逾隙	语言学
张作相	人物
不准	词语
逾次超秩	文化
减水剂	科学
龙骧虎啸	成语
龙骧蠖屈	汉语
龙骧蠖屈	词语
地开石	地质
威名	词典
销毁骨立	熟语
示	汉字
痛心切骨	语言
舐皮论骨	成语
舐皮论骨	熟语
舐皮论骨	文化
曝骨履肠	词语
鸡骨支床	典故
捶骨沥髓	熟语
节欲	性生活
节欲	早泄
国民学校	德国
奇偶校验	石油工业
奇偶校验	科学
苍雪	佛教
寄禅	文学
方工	英雄人物
开辟	词语
舷墙	航海
standfast	流行音乐
铃木光司	小说家
塞鸿秋	元曲
阎达开	河北人
戈氏鸟	古生物
杭州网	技术
紫宛	花卉
黎里镇	地区
优势	围棋
trojan	木马
氟氯烷	化合物
丁于	明星
郎之万	法国
氟钛酸钾	钾盐
贝克西	人物
居约	人物
库利吉	人物
阴丽华	东汉
严诗金	烈士
高有鹏	副教授
登月	航空航天
笔帽	艺术
马瑞芳	人物
余仁凯	作家
晓卉	人物
余薇野	名人
金轮法王	武侠
小剑	人物
朱华亭	人物
齐南峰	人物
猩红	科学
硫氰酸	化学
唐山镇	地理
代位	法律
雕龙记	影视
王东京	经济学家
旅行支票	旅游
苏少棠	伶人
溅射	dota
正阳县	地理
莫里	人物
皮尔里	人物
平卡斯	人物
军威	词语
扭扭捏捏	文化
林锦堂	人物
吴立昌	名人
三氯化锑	科学
三氯化硼	科学
氯化汞	无机化学
基特	人物
明灭	文学
梅干	生活
磐安县	中国
波列夫	人物
寻血犬	宠物狗
刘北茂	音乐
隆昌寺	江苏
氰化钠	科学
斗牛舞	舞蹈
西布曲明	医学
马步升	小说家
张榜镇	区域
副博士	教育
李剑萍	北大
杰勒德	人物
多马克	人物
细胞液	自然科学
∩	符号
圠	中国
硫化物	地质学
萼片	自然
荣昌县	地理
荣昌县	农业
博陵	地理
碧夏	人物
瓦登海	海湾
萧墙	典故
许树	人物
李正天	画家
戏彩娱亲	成语
乙酸铵	科学
中华民族园	北京
郭霍	人物
贫铀	科学
遵纪守法	典故
马明春	名人
仲丁胺	科学
马秋芬	文学家
龙之吻	影视
乙亚胺	科学
谯城区	安徽
子书	诸子百家
樟脑	中药
批准文号	药品
安利	社会
掉三寸舌	字典
许世英	人物
玄妻	神话传说
飞卫	传说
好搭档	娱乐
燕美人	农作物
洗面奶	商品
平凉	甘肃
三明治	生活
光泽	塑料
锲	汉字
打白条	社会
阮兆辉	艺术家
尹飞燕	艺术
斗鸡眼	五官
量子	科学
马口铁	化工
水冷壁	工业
郭松龄	军人
山梨酸	营养学
五一劳动奖章	国际
长夏	科学
水质标准	科学
李森祥	编剧
氟牙症	口腔疾病
緜	文化
psp	技术
windowblinds	美化
益母草	植物药
离岛区	地理
天津歌舞剧院	机构
陕西省戏曲研究院	机构
海韵	诗歌
压敏胶	应用科学
刻薄	汉语
磐	维吾尔族
班会	同学
基本词	语言学
互溶	汉语
玄冕	服饰
仇春霖	人物
丁艾	中国
卞毓方	中国
岁晚	文学
鞄	语言
牛鲜茶	药品
跳舞机	舞蹈
mho	信息化
肥煤	地球科学
袁大化	民国
惊羡	汉语
牛形灯	文物
熊灯	历史
溴化镁	科学
乐蒂	香港
烹	汉字
中国农业科学院哈尔滨兽医研究所	院所
陶玛斯	神话
真壁城	城池
丰泽区	福建
隋唐	历史
废渣	营养学
开标	名词
刻骨	词汇
羊双肠	小吃
献殿	太原
纪公庙	生活
民和回族土族自治县	地理
单子	名人
杨锡光	名人
К	字母
总线	冶金
陈世铭	人物
易木	名人
杨仲德	名人
大叶红	花卉
本源	词源
非金属	定义
雷山县	旅游
离心	生物化学
pomotion	营销
pomotion	商业
信笔涂鸦	文化
一表非凡	文学
落草	习俗
潘玉茂	石刻
于康震	兽医
茄科	自然
乌姜	姜目
mode	女装
引子	词语
慕容世家	网络游戏
镇雄县	云南
镇雄县	昭通
永善县	旅游
乙硫醇	分子生物学
仓山区	地名
墨尔本	地名
金贝贝	电脑游戏
纵横开阖	词语
拉孜县	青藏高原
纵风止燎	熟语
侈纵偷苟	汉语
日月湾	旅游
盖竹洞	道教
相州	地理
小沙镇	地理
祖印寺	地理
文畅	名人
支克坚	文学家
杨明渊	人物
奇怪	解释
器满则覆	词语
器满则覆	语言
绮园	旅游
说亲	婚姻
废品	词语
毫微米	计量
丽江人	旧石器时代
立决	法律
警报	信号
天摇地动	语言
师表	成语
罂粟碱	内科学
屈臣氏	著名品牌
太妹	环境
同性恋	gay
方小宁	中国作家协会
杨金亭	文学家
杨桂	文学家
杨容方	作家
杨季征	作家
牧欣	作家
舒慧	人物
杨衡钟	作家
晓黛	文学家
王士心	名人
卫兴	中国
宝光殿	地理
川槿皮	应用科学
李渤生	人物
纪家塔	建筑
琼楼玉宇	词汇
阴长生	道教
真光	社会
八国集团首脑会议	经济
约略	百科
估计	分子生物学
郑桓公	诸侯
毕业考试	书籍
线段	机械制造
制售	文化
差动滑轮	物理
李庆长	模范
李佛金	人物
楚太祖	晋朝
熊秉坤	武昌起义
石寺镇	河南省
曹村乡	地名
陈蝶仙	作家
板石	科学
林述庆	烈士
邵力子	人口学
沈钧儒	北海
朱子龙	英雄
秦毓鎏	人物
鱼麟洲	风景名胜
镍	化学
砷	营养学
铑	化学元素
高士杰	京剧
肇源县	黑龙江
谨毛失貌	文化
宿墨	国画
爵士队	爵士
李世良	红安
铁冬青	中草药
玉皇洞	景点
钟楼区	地理
古猗园	上海
中央美术学院美术馆	文化
体波	地震
何祚欢	名人
察布查尔锡伯自治县	新疆
吴国敬	港台明星
老黑山	科学
苏兆登	山东
谢自然	社会
锦江区	四川
若尔盖县	中国
积石山保安族东乡族撒拉族自治县	甘肃
杜永峰	人物
盘龙区	社会
兰坪白族普米族自治县	地名
法商	法律
李笃培	建筑
毛烽	文学
徐世寿	昆山
云台峰	地理
大清谷	杭州
迫不得已	语文
顺平县	地理
南溪温泉	浙江
维尔哈伦	人物
标准化	术语
标准纬线	科学
克莱罗	物理学家
一鼻子灰	文化
牟山	地理
靠背	墨西哥
一时之秀	文化
严迅奇	人物
软弱无力	词汇
惧内	词语
九牛二虎之力	文化
隆德城	城市
赵凤翔	作家
峨庄	旅游
肖克凡	小说家
一萍	文学
张雨绮	人物
章守玉	教授
衷心	词语
毕玉蓉	人物
田文寿	学者
钱之光	名人
火山灰	地质学
舌尖	应用科学
兵燹	词典
褊急	文学
吴稚晖	教育家
赵长印	天文
冯珑珑	科学家
吕继仪	名人
尚丽华	评剧
陈智林	戏剧家
星子镇	地理
祝融星	天文
青沙	景点
金鹿园	景点
自如	词典
丙烯醛	化学
井蛙之见	文化
大肆铺张	成语
]	物理学
维德曼	文字
小龙湫	旅游
linpack	计算机
马岙潭	洞头
马西京	艺术
葫芦山	山脉
大愚若智	历史
林尊	人物
孙冰轮	中国
白原	名人
陆绿曦	名人
兰渝铁路	重庆
直译器	电脑
甲拌磷	农业
碱式碳酸铋	药理学
普斯卡斯	人物
傅增湘	人物
母瑞山	风景
玉龙泉	风景
南楼	古迹
超数排卵	自然科学
刘湾镇	乡镇
照射	科学
肽键	化学
柳侯公园	文化
释星云	台湾人
油泵	冶金
马颂德	科技部
金猴岭	神农架
陆伟然	人物
陆永昌	人物
陆明伟	文学
阿伊	文学家
侍继余	人物
过氧化苯甲酰	化工
唐钟	旅游
诸葛楼	生活
吴定国	作家
王方晨	文化
艾尤塔雅	建筑
郑祖康	人物
搜狗	互联网
高阳市	地理
旱冰鞋	运动
龙缸	旅游
巴岳山	永川
布希球	生活
邱比特	传说
波束波导	物理
张作哈	四川省
乐陵	德州
马斯喀特	首都
将功赎罪	语言
杜少府	古人
张来武	北大
王兆安	教育
赵克志	江苏
赵克志	政府
孙忠焕	市长
泸沽湖	七夕节
李彝超	人物
桂花	灌木
包天笑	名人
陈昌凤	新闻
疲劳	生物力学
超短波	物理学
林中斌	军事
汉族	华夏
坦桑尼亚	赤道几内亚
赵白鸽	人物
柏应理	比利时
阈限	心理学
分支	物理学
劣种	生物化学
文告	词语
玉屏峰	山峰
龙虎殿	景点
文责	词语
石燕洞	江西省
易帆	专栏作家
周介人	文学家
桑城	文学家
周丝仪	文学家
人民卫生出版社	文艺
周佩红	文学家
轻骑	经济
人民音乐出版社	出版社
吴连枝	武术
灵敏度	能源科学
奥菲	影视
冰峪	地理
戴立忍	港台明星
朱砂	颜料
一言不发	词语
结构图	图形
波登管	物理
波纹管	技术
易道术	哲学
易道术	文化
齐武公	君主
红兰姆	体育
幡然悔悟	文化
木瓜粉	美容
梁吉	名人
信源	科学
webqq	技术
耳洞	歌曲
干海子	景点
泄密	科学
天沐温泉	度假
周微林	作家
王胜朝	人物
周鹤	文学
马伏	文学
美丽陷阱	剧情片
楚熊挚	湖北
迁徙的鸟	娱乐
步弓	词语
铃木绫子	柯南
杀出重围	反恐精英
潘自力	陕西
芮城县	运城
浮力	物理学
邓文中	教授
塑性变形	物理学
摩擦角	科学
季成家	文学家
季成家	名人
洛赛克	科学
徐景贤	文革
潘世告	名人
陈代富	四川
天台峰	景点
万利达	经济
原佳名	柯南
克莱德河	旅游
呱呱堕地	成语
观星台	地理
氨基糖	科学
年辈	文化
年高	文化
年货	社会
年纪	汉语
丁长华	名人
酥饼	饮食
刘子衡	人物
朱道南	山东
诸葛军垒	甘肃
蒙山国家森林公园	景点
迷惑	艺术
大厦将倾	词语
元木	地名
神霄派	宗教
大开杀戒	动作
铁面人	法国
房文斋	中国作家协会
庞瑞根	名人
庞天舒	作家
加德满都	尼泊尔
心爱	专辑
装配图	建筑材料
言不及义	语言
严丝合缝	成语
寿衣	民俗学
沙依巴克区	少数民族
许贵成	太极
托克逊县	新疆
托克逊县	地理
萧明魁	太极
古柏镇	地理
树木园	公园
丙种球蛋白	自然科学
易仁寰	名人
林祁	人物
林予	文学
工艺流程	生产线
月偏食	奇观
主食	词语
起诉权	社会
齐康公	齐国
励磁	交通
虫媒植物	自然科学
化缘	宗教
出航	百科
专集	文学
专集	词语
曼谷	旅游
exiderdome	展览
蒲剑	将领
颞下间隙	医学
作词	文化
阿莫罗芬	处方药
霍大同	心理学
消释	词语
拼写错误	语言学
莱佛士酒店	酒吧
切花	自然
林滔	文学
林承璜	文学家
申猴	文化
莘庄镇	地理
528	技术
梁文冲	体育
山茶油	饮食
理屈	词语
淋巴瘤	科学
休战	剧情
伍连德	医学家
良相佐国	离婚
良相佐国	唐朝
公民投票	民主
北静王	人物
李子园	教育
修身齐家	语言
梅叔鸾	越南
溶解氧	电力
措辞	词汇
知更鸟	鸟类
规格	词语
蔡忆	名人
欧之德	剧作家
欧阳文彬	经济
阿丽拉	法国
骚乱	历史
辛瑞那	影片
低潮	词典
李佳妮	民歌
过午不食	佛教
形如槁木	典故
兴邦立国	典故
新愁旧恨	成语
飞行技术	教育
路虎	越野车
变法	政策
塞尺	机械工程
湖西	山东
湖西	河南
兰博基尼	生活
雷城	文化
宋庆龄	人物
偏向	词语
循环论	物理
青铜峡	旅游
氢	自然科学
97	计算机系统
碘	科学
国家体育总局	体育
间歇热	诊断学
75	文化
硝酸	无机化学
109	数学
二氧化氮	化学
吕威璜	人物
简装	装裱
碳酸	科学
氧化铝	化学
木卫三	天文学
十里堡	地名
触诊	健康
黄鹄	教授
瞥	汉字
申升勋	明星
氧化镁	无机化学
氢氧化镁	自然科学
限	汉语
上乘	佛教
鹅肉	中药
非洲统一组织	机构
铬	营养学
彻底	生物化学
夏目漱石	文学
周恩来	新文化运动
周恩来	残疾人
贺龙	元帅
氯化铜	无机盐
酵解	生理学
毕宿五	自然现象
唯识	宗教
沓冈复岭	语言
踏故习常	语言
泰山盘石	文化
泰极而否	文化
泰山压顶	文化
探头缩脑	文化
痰迷心窍	成语
痰迷心窍	文化
贪猥无厌	成语
谈吐生风	文化
洪福齐天	汉语
之前	词汇
旱烟	词语
力臂	机械
精神分析	生物化学
韩恢	历史
电压	通信
尖端放电	电力
尹素怡	明星
欢乐城	影片
张自忠	烈士
罗会文	名人
硫酸镁	能源科学
硫酸镁	化学
硝酸镁	化学
东野圭吾	作家
曾益新	医学家
王粲望	文化
司箫星	天文学
司理星	自然科学
世界贸易组织	国际贸易
王家骐	科学
三维	三维动画
吴培亨	科学
刘广志	科学家
网路	电脑
楚云飞	演员
传动比	机械工程
校史	文化
日出日落	文化
夏有志	文学家
席萍	文学
柳方眉	文学家
毛用泽	物理学家
于润沧	中国工程院
会议	九三学社
库纳	钱币
赵国祥	河南大学
低眉	现代文学
权磊	足球明星
统筹兼顾	成语
湿热	医学
散置	园林
嫦	汉字
徐绪桓	文学家
琥珀突变	基因
西羽	人物
皇甫庄镇	地理
娘娘腔	同性恋
西蒙一世	历史
齐藤荣	文学
谷恒生	推理
刘玉方	人物
反比	术语
击球	排球
djmax	网络游戏
徐茂魁	作家
侯选	历史
马玩	人物
天卫十九	天体
镇原县	农业
伴侣蛋白	自然科学
杨逢彬	教授
哑巴	词汇
插页	书籍
spore	模拟游戏
谭希培	人物
蔡宗健	搜狐
红缨枪	居家
正割	几何
正切	科学
余切	几何
芦边拓	人物
太田忠司	文学
巴金星	天体
化学肥料	农作物
东宗寺	寺庙
热固性	化学
斯德哥尔摩	奥运会
不屈不挠	语言
兰山公园	兰州
红庙子	地理
语序	语言文字
简本	语言
雀巢公司	外企
嘉琳	歌手
液压泵	物理
网络通信	通讯
温吞	词语
tvb	广播电视
李露	人物
福泉	地理
天半	汉语
天趣	佛教
天文数字	文化
中缝	书籍
薄壳	建筑设计
半犬	新生代
焦兽	第三纪
马林巴	文化
禹功散	医学
倜傥	词汇
大海雀	鸟类
江采萍	唐朝
包富红	人物
徐子心	人物
顾真安	人物
程坤	人物
秦晓	人物
鱼口	地理
郑申侠	河北人
童金苟	人物
李存修	人物
诗吟	文学
重阳节	传统
全佑	武术
田垄	解词
添设	汉字
滕维藻	人物
助词	社会科学
李浩泉	将军
张广天	名人
彭启丰	人物
边宝泉	戊戌变法
子午谷	书名
李克仁	文学
徐剑艺	文学家
填满	汉字
edit	命令
夏依坦	柯尔克孜族
便签	文具
宗悫	文言文
忆文	武侠小说
西尔斯	商人
倒摄抑制	心理学
阿霉素	医学
于君道	道教
无援	小说
龙角山	山峰
电弧炉	铸造
甬道	词典
lomo	摄影
景区	机构
叶金	人物
海若	东海
李佩芝	人物
卫报	报刊
老歌	篮球
夏菊花	演员
奥尔洛夫	人物
欧美	大洋洲
巴亚斯	民俗
博尔尕	艺术
闪蒸	机械
实打实	成语
科龙	品牌
徐德志	作家
岩爆	地质灾害
定价	词语
阎朝隐	人物
暴鸢	战国
地洞	文化
童亮	故事
源程序	建筑学
打点	解释
拉扯	词典
玄奥	百科
陈仲华	国画
偷猎者	网络
坐禅	气功
吡柔比星	药理学
云片柏	木本植物
累累	汉语
生物降解	自然科学
财务危机	经济
财务危机	科学
急促	文化
黑狼	网络游戏
连拱	生物化学
闭关锁国	社会
麻婆岛	喜剧
一见锺情	名词解释
遁世绝俗	文化
红矾	化学
妖狐	火影忍者
朱批	制度
契机	文字
心电图机	医疗
心电图机	科学
氮芥	应用科学
氮芥	生物化学
马丁内斯	体育人物
王惠娟	诗人
租税	经济
马丁内斯	总统
薛汉伟	文学
拿人	词汇
带宽	术语
石鸣	作家
涂乃贤	人物
弦柱	文学
朽索驭马	文化
黄埃	词汇
黄表纸	迷信
金贲亨	临海
红茶	茶道
宏大	词典
德涅斯特河	河流
绿肥	术语
绿油油	交叉学科
贝塞耳	天文学家
恭敬	词典
闲适	文学
好得快	中成药
逐步求精	科学
厌学症	生活
青霉素	自然科学
埃林顿	人物
科森扎	地理
悬吊	词汇
喧叫	汉字
ayura	彩妆
渲	汉字
cort	吉他
雅培	公司
虹吸管	科学
泛灵论	生物
杨善集	海南人
万代千秋	文化
万汇	词语
暴利	社会
周作民	画家
故障	电子
扯后腿	词语
内聚	涂料
人民调解	社会
玄米茶	生活
李昶怡	河北
须德海	海洋
骏马奖	少数民族
沈宗瀚	人物
人参精	药品
白血病	内科
义齿	口腔
皇恩	词语
荒郊	百科
赔偿损失	宪法
和平相处	词典
梧鼠之技	中华文化
敦刻尔克	现代史
耻笑	词语
陆鱼	台湾
岳美中	名人
方巾气	文化
方面	文化
北京口腔医院	应用科学
过敏症	生活
dbc	技术
肖钦	体育
媺	词汇
横轴	运动
刘攻芸	名人
仿真器	通信
百米	词语
抽样误差	经济学
柴枥	人物
瘌痢头	生活
复合膜	化工
居里点	物理学
孟席斯	总理
火山学	地理
火山学	物理学
灋	生僻字
潘心源	军人
黄彝	湖南
白消安	医学
胡少海	人物
方红霄	人物
杜学芳	河北
谢万	历史
帕罗西汀	应用科学
贾小伟	人物
加的夫	英国
中表	称谓
权化	术语
扎眼	休闲
克氏蛤	化石
千斤重担	词语
千周	科学
东观西望	文字
东观西望	语言
缠足	风俗
古存华	四川
车永辉	抗日战争
数字网	名词解释
五权宪法	孙中山
颉颃	汉语
月龄	天体力学
邹采琳	名人
卷丹	药用植物
白丝裙	娱乐
凝视	词汇
花燕芳	名妓
波峰	物理
高发	人物
马塔伊	科学家
显灵	文学
祖鹿	新生代
贤德	词语
邓一飞	文学
邓清	抗日战争
阻尼振荡	自然科学
周书领	作家
水色山光	文化
斗色争妍	成语
宝物	解释
何纾	云南
具体化	社会科学
文山区	台北市
栾剑	影视
赛道	赛车
赛道	词汇
必备	词语
半月板	医学
半月板	骨科
兵士	解释
陈永柱	军事家
马仲英	民国
名酒	鉴别
法鲁	葡萄牙
范振钰	艺术
方奎	中华
邓从凯	广东
董鸿铭	历史
李乾朗	古建筑
董正香	革命烈士
范春元	历史
范郁文	革命烈士
负德背义	成语
陈再励	人物
土壤胶体	化学
合式公式	科学
鱼腰	中医药学
鱼腰	针灸学
关元	科学
关元	药品
中极	针灸
至阳	医学
德尔斐	世界遗产
刘连群	天津
格列齐特	药学
谎价	汉语
莫伸	著名作家
日前	百科
日色	汉字
日色	文化
日夜兼程	百科
日杂	汉语
秋后算帐	解释
月份牌	百科
月事	应用科学
青灵	穴位
支沟	土壤学
赵劲夫	河北
居住	语言
侠白	穴位
孙凤武	体育人物
杜微波	历史
亲和力	容祖儿
崔晓立	人物
崔真吾	抗日战争
段洁仁	抗日战争
千推万阻	文化
塞涅卡	文学
白洋淀	地理
长丰县	行政
店名	开店
冰雾	术语
醉翁亭	旅游胜地
白血生	药理学
张长禄	文学
辷	汉字
仲兴周	人物
邬宝恒	人物
薛范	音乐家
李六乙	导演
散装	质量
神池县	地理
眼科学	医疗
汤友常	人物
单春	表演
徐乃麟	台湾歌手
欢呼雀跃	文化
欢呼雀跃	语言
溶菌素	医学
溶菌素	科学
苏诺	医药
依地酸钙钠	医学
陶行知纪念馆	南京
冷场	术语
冷场	曲艺
救场	行话
楞场	艺术
新昌县	城市
利水茶	保养
雌雄异株	生物
罗啸天	内蒙古
禁令	法律
氯化锂	自然科学
跃居	词汇
珠江	地理学
杳不可闻	词语
狗肺狼心	熟语
曾勉	学者
娄溥礼	科学家
卫穆公	卫国
砾	土壤学
憔悴	字典
蚓激酶	药品
易蒙停	科学
病毒灵	药理学
甘油醚	医学
保亭	地理
江楼	杜牧
咏春拳	武术
桑戈尔	政治家
尺寸	机械
大路活	行话
鸟松乡	乡镇
寿比山	医疗
梓官乡	地理
磁环	自然科学
书屋	杂志
毕摩	社会
功能性	法律
建文	历史
雕刻家	释义
国家人类基因组北方研究中心	机构
承山	医学
庐山面目	汉语
宿管会	上海理工大学
如痴如醉	语言
壶中日月	词汇
集萤映雪	汉语
琴瑟失调	汉语
琴瑟失调	文化
六龟乡	台湾
苯扎溴铵	科学
墓园	词语
陈兼善	科学
柳晴	讲师
刘祖培	人物
穿山甲	科学
雌二醇	分子生物学
黄体酮	药理学
波罗鸡	文化
黄埔区	广东
豻	汉字
核液	科学
鱼肚白	文化
洋车	运输
行业软件	软件
孊	字典
黑拳	电影
尹子维	主持人
汽锅	烹饪
成千上万	文学
山水相连	语言
曲马多	医学
维尼安	医学
冬柴铁三	人物
磨刀机	机械
礸	文字
鶵	字典
远日点	流星雨
侯希贵	慈善家
色球	科学
鹅不食草	应用科学
头孢氨苄	药理学
显著性	商标
头孢哌酮钠	医药
lrma	人物
倍他米松	药学
二氧化铅	无机物
彭水苗族土家族自治县	少数民族
举步维艰	文化
焉荣竹	政治家
杨传升	名人
德比郡	体育人物
德卢斯	地名
德林湾	地中海
陈其旋	美术家
绝食	生物化学
丰镇站	京包线
温室效应	科学
刘怀廉	简历
睫毛夹	化妆
刘粤军	人物
大阪市	地域
兰亭图	善本
卞启明	烈士
老虎屁股摸不得	俗语
冽	语言
宋泰坤	棋手
潘仲骞	企业家
噪声温度	噪声
雷台	地理
冀雅翘	人物
巴德冈	建筑
前金区	地名
红黎深	动漫
不丹	亚洲
玩意	词语
王明方	人物
任宗德	艺术家
王澍华	绘画
满贯	体育
高雪岚	歌手
三金	药品
金平苗族瑶族傣族自治县	地理
牛蔓	中草药
鱼汤	饮食
帆板	体育
万代	娱乐
墨镜	化学
李太忠	人物
杨东莼	广西
杨佑之	人物
杨佑之	国民党
何炼成	湖南人
乐天宇	人物
黄大戟	中草药
马钱子	医学
辳	语言
挊	语言
蝡	汉语
应酬	百科
应和	汉语
应声	词汇
应天顺时	文化
应天顺时	百科
杨玉璞	美术家
咸清	中国
用一当十	语文
马缨杜鹃	农作物
黄小玉	瓜果
红小玉	西瓜
宋文谋	抗日
延边朝鲜族自治州	地理
太阳系	自然现象
哈雷彗星	太阳系
哈雷彗星	天文学
海洋能	科学技术
冲压	机械零件
输血	内科学
扦插	科学
廊	建筑业
浪漫主义	文学
冯仑	地产
竹地板	居家
镀锌管	装修
碔砆混玉	解释
大坑	湾仔区
朱元暹	人物
专利公报	法律
专利公报	社会
獤	词汇
獢	生僻字
犓	文化
阿以旺	文化
仇晓	人物
沈孝瞻	五行
阿尔杜塞	法国
雨花区	行政区域
宁乡县	长沙市
王育诚	台湾
哀怜	词典
韩子谦	新文化运动
白泉泰	历史
赵金奎	将军
喷涂	科学
8毫米	娱乐
8毫米	电影
云泉寺	旅游
万美汐	艺人
富察氏	姓氏
佐藤珠绪	艺术
埃德蒙顿	地理
卡片机	类型
杨忠道	人物
耿介	历史
柴凌阁	革命烈士
刘建超	人物
米利都	地名
田承忠	官员
大陆泽	河北
寇荣	历史
宋汉	东汉
寪	语言
融安站	交通
牛蒡	自然
陈国铨	历史
鹞	字典
水利部松辽水利委员会	机构
普法尔茨	德国
核爆炸	科学
木美人	艺术
波德戈里察	欧洲
玻片	生物
玻片	科学
mask	cosplay
范小天	江苏人
达斡尔	旅游
李伟菘	明星
樊准	东汉
潘金根	艺术家
螕	汉语
螏	汉语
蝿	汉字
当归	自然
去离子水	电子技术
沙隐虫	生物
隐讳	词典
习练	熟语
马志鸿	总裁
肌肉男	词汇
宋兆钦	人物
谈增福	人物
陶培麟	人物
木笔	生物
沈迅	莱西
哈佛大学	高等教育
斯坦福大学	社会
硝石	中药
蔚州	山西
shutdown	科学
沙苑	地理
懩	词汇
郭琨	法律
交通信号	外语片
翠龙	种植
玉柄龙	兵器
宝地	宗教
外观	自然科学
羊兰芬	人物
呼玛县	地理
万昌平	画家
马国超	文学家
王秀川	人物
赵孝	人物
地下党	称谓
自助餐	饮食文化
小额贷款	创业板
怀卡托	新西兰
达尼丁	地理
传送速度	传真机
小房	称谓
桔皮	植物药
真禅法师	宗教
格敦群佩	社会
魏雅华	小说家
赵亦民	人物
赵亦民	文学家
马志鹏	官员
韩升洙	韩国
隋秀梅	领导
王心阔	人物
脱壳	编程
脱壳	黑客
吹毛求瑕	成语
吹毛求瑕	文化
橘庆太	人物
基础课	汉语
国际收支	贸易
垂帘听决	成语词典
邓允庭	革命烈士
佩克利斯	科学
垂头铩羽	词典
垂头铩羽	成语词典
铢量寸度	成语
众口交传	文化
宛志文	编辑
随声附和	文化
邱琦雯	港台明星
目的	科学
查莫湖	地理
周娥皇	皇后
吕庆庚	学者
冯广	人物
吕锦华	文学家
吕晴飞	名人
吕树坤	学者
卜成中	名人
工业体系	电力
速成	词语
吉尔福特	心理学家
化风	病理学
次官	词语
次级	生物化学
atan	函数
bdosptr	计算机技术
抑制剂	医学
biostime	计算机技术
chdir	函数
ctime	计算机技术
懊悔不已	词汇
幽咽	汉语
特地	词汇
秀美	词语
就擒	词典
就要	词汇
亲兵	词典
亲口	汉语
亲缘	术语
单打一	语文
十道	佛学
烟膏	毒品
官生	职业
台座	雕塑
雁溪	景点
雁荡	景点
冯树功	人物
冯敏刚	人物
薄层层析硅胶	自然科学
朱铁志	学者
长傲饰非	典故
如石投水	词汇
如临深谷	文化
三迭阳关	词典
三迭阳关	成语词典
时逸人	医生
不齿	词典
加工余量	机械工程
忍辱含垢	俗语
徐赫	人物
肠系膜	自然科学
蔡仲娟	插花
孙里	学者
flushall	计算机技术
flushall	程序
flushall	函数
fputs	函数
frexp	程序
对生	生物学
言者不知	成语
义正辞约	文化
有志之士	文化
张甲洲	政治
多智龙	自然
原尾目	自然
诡辩	哲学
思乡曲	艺术
宗馥莉	人物
慎用	医学
德清大师	人物
swim	英语
成瘾性	药理学
去油	医学
遁名匿迹	词典
孙凤城	名人
孙光萱	文学家
孙迅韬	文学家
孙华炳	人物
闽东	地区
化学分析	药理学
弦索	文艺
肖文清	厨师
王水莲	人物
枋心	万方数据
阖家	词汇
性犯罪	社会
国别史	文学
走卒	汉语
丁烈云	大学教授
乐骋	生活
巴斯温泉	生活
毕奂午	文学家
三街六市	文化
博兴	旅游
诲盗诲淫	语言
江迅	著名作家
余劲松	国际法
张中载	博导
汪嘉斐	人物
直射光	科学
胡宗山	副教授
丁言仁	人物
李大宁	官员
陶秀伟	官员
李铁君	人物
不完全叶	生物
不完全叶	植物学
巴布海	人物
三阳交泰	文化
犯颜极谏	典故
麻麻地	方言
裸露	词典
帕珠沙星	科学
乐城镇	地理
孙维韬	作家
伊蕾	人物
马延站	交通
英姿勃勃	俗语
缪刺	针灸
糖浆	药品
臀围	人体
臀围	工艺
臀围	美学
范先佐	人物
孙智正	社会活动家
碧山镇	地理
莘塍镇	地理
桥下镇	乡镇
像素	自然科学
色如死灰	成语
牛痘苗	科学
单姓	百家姓
向壁虚构	语言
三魁镇	社会
焊接	社会
汪焱钢	人物
刘钊杰	教授
曹风	人物
启蒙	教育
齐沪扬	上海师范大学
赵君陶	人物
金淘	福建
花信风	广播
杨叶	艺术
时永乐	人物
韩成武	教授
田小军	人物
范铁权	学者
田质成	作家
势在必行	文化
机化	应用科学
渗出	放射线学
炽热	语文
兴仁县	旅游
栓子	医学
巨屿镇	浙江
泽雅镇	温州
宣扬	词语
王登伦	抗日战争
祁建中	副教授
雪花膏	社会
曲延坤	学者
之伟	人物
阴极射线管	示波器
冯潇霆	足球明星
朱振芳	名人
契友	词典
艺术摄影	艺术
黄云明	教育
暴盲	医学
武岗镇	安徽
劲草	名人
木火	作家
立文	人物
朱立元	教育
责备求全	成语
心惊	生理
终成泡影	词典
女囚	影视
金宇彬	演员
费德昭	人物
sponge	外语
甘棠站	车站
癿	网络
岳金库	教练
新加坡	旅游
卢万	地方
卢尼河	印度
卢尼河	自然科学
卢帕河	水系
北干巴鲁	地方
弹力袜	静脉曲张
朱孝池	作家
朱旭明	文学家
朱希江	学者
萧凝	学者
朱金晨	文学家
潘一福	革命烈士
潘遐林	湖北
潘介棠	革命烈士
京广中心	深圳
沅陵县	地理
能歌善舞	成语
周铁焕	政府
周铁焕	人物
屈方方	政府
壤中流	地理学
立等	语文
程明安	学者
周进芳	人物
姜建设	郑州大学
刘铭恕	人物
1926年	年份
西明寺	唐朝
卡伦河	水文学
中风	中医学
阴暑	中药
潘本登	革命烈士
陆淑娟	人物
陆淑娟	名人
李悦娥	人物
董洪运	官员
薛万明	孟门
韩新巍	教授
鲁地村	村
万州区	中国
刨根儿	词典
高俊林	郑州大学
王书才	人物
庹万鹏	革命烈士
小西峰	地理
南峰	陕西
苏朴	文学家
汤恒	文学家
汤素兰	学者
汤素兰	文化
贺慈红	浙江人
教室	教育
吉娃娃	自然
解说词	写作
述职	词语
李业兴	南北朝
裴让之	文学家
纪叶	影视
李霞裳	作家
普度群生	文化
史建瑭	军事
卡拉拉	人物
卡塞塔	文化
阎又文	人物
甲硫氨酸	分子生物学
分段法	科学
赵建才	公务员
纹路	犯罪
泼尼松龙	医学
葛珂	人物
众望攸归	文化
叶瘦花残	文化
缝隙	电磁学
木头木脑	成语
木头木脑	语言
服法	中药
十八斗	艺术
伍柳派	事件
府绸	家纺
鹰犬	解释
霞山区	湛江
赋形剂	生物化学
覆辙	中医学
库班河	水文
布吕根	文化遗产
石棚	建筑材料
利塔尼河	水域
克孜勒河	水业
博宁	应用科学
科洛曲	药品
话语权	社会
借古喻今	文化
生荣死衰	文化
徐培晨	花鸟画家
李绍新	人物
阙庭	医疗
扶乩	占卜
门户之见	成语
眉睫之内	文学
猛虎添翼	成语
迷惑视听	文化
眉飞眼笑	文学
喀什地区	中华人民共和国
语料库	应用科学
金莺羹	食谱
点化	词典
感奋	文化
刚正	语言
高足	词典
冉闵	名将
割据	词典
我负子戴	成语
涔	生僻字
觇	汉语
埃尼奥	希腊神话
财务结构	理论
连望坡	旅游
王凤友	人物
阻抗	自然科学
伊利运河	地理
分发	技术
呌	汉语
吤	汉语
王艮忠	名人
咊	汉字
咉	生僻字
孙效东	人物
观众	汉语
靡知所措	文化
面谩腹诽	文化
靡坚不摧	词典
靡然顺风	文化
废气	大气污染
眠花藉柳	成语
腼颜事敌	词典
废立	词汇
华夏鳗	奥陶纪
赵亚华	教授
曹先维	内蒙古大学
杨万全	四川大学
旋转乾坤	名著
书法网	书法
书法网	网站
螺旋管	冶金
宣化区	旅游
李益荪	参事
曹顺庆	文化
割尾巴	词典
更次	词汇
梗塞	科学
利复星	药品
郭泰辉	运动员
振捣	建筑
finaltoon	动画
壁泉	科学
慈圣庵	峨眉山
王魁溥	共产党员
王福清	烈士
朱翔宇	人物
光物理	物理
房灵敏	人物
崔建忠	黑龙江
依艳丽	沈阳
令亲	词语
生拖死拽	文化
哸	汉语
范洪远	人物
何昌荣	自然灾害
韩泰裕	运动员
楼阁台榭	成语
楼阁亭台	词汇
露天	地理
朱道华	人物
周柏卓	科学技术
図	汉语
嚽	汉字
盛极一时	成语
瑞鹤	词语
工料	经济学
项昕	元代
于法兰	宗教
巴布亚新几内亚	不结盟运动
民生涂炭	语言
名不虚得	文化
抹粉施脂	语言
绝对误差	自然科学
雅鲁藏布	地名
甲基对硫磷	有机化学
宁陕县	安康
李真瑜	教育
聂秉新	名人
啠	汉字
啫	汉语
嗭	汉字
王其书	名人
曲文秀	烈士
泰兴	江苏
西岱岛	旅游
王卿芳	经理
袁琼嘉	人物
何恩良	名人
多佛尔	地名
徐德宽	共产党员
紫阙	汉语
卡马森	城市
周魁	医学
空谷	大学
程小蓓	诗人
衷肠	词语
挨个	词语
才女	女性
范洪春	淄博
收益权	法律
对外开放	经济
龚亚夫	教育家
公德	词典
公因子	机械
狂悖	文学
倪光南	联想
拼读	汉语
拼写	汉语
拼死拼活	词汇
拼字	词典
吴银实	人物
药房	应用科学
蛋白组	生物学
王庆艳	河北人
宫观	宗教
巩固	词语
巩固	汉语
共晶	物理化学
共晶	自然科学
共事	词语
王荣根	飞行员
余金成	教授
田晓文	人物
随乡入乡	成语
随声吠影	成语
随俗浮沉	词典
随物赋形	语言
岁稔年丰	语言
楚儿	民族
够戗	方言
电铸	表面工程
加什河	地理
开步	词汇
开步	汉英词典
开店	经商
开戒	词汇
开犁	词汇
开锣	词汇
开篇	文学
开戏	词典
开心颜	俗话
开学	汉语
部委	词典
神学目的论	文化
加尔达湖	意大利
笔供	词典
笔力	艺术
王润真	河北人
郝培文	人物
笔译	科学
管界	法律
沟坎	汉语
王圣学	所长
郑成龙	体育明星
无影	方言
修口石	石头
缕陈	词典
晋京	词语
药味	词典
开赴	词语
扭力	科学
米筛目	菜谱
黄明开	广州军区
湖沼学	湖泊
雅尔	法国
查哨	词语
查证	法律
赵常贵	人物
敬爱	词语
孝子爱日	语言
骄爱	科学
冯德尔	人物
兰佩杜萨岛	地理
白令岛	水域
王寿荣	人物
曹金月	烈士
方仁俊	音乐
彼	文学
过半	词汇
过磅	词汇
过活	文学
过虑	文学
过誉	常用
过誉	文学
卷宗	词汇
骨碌碌	词典
广州话	文化
冷启动	计算机
金牛山	地理
孙锦顺	足球
萧荫堂	人物
大腿	科学
假肢	生物学
董朗	历史
上海战役	军史
严辉	博士
王贺炬	人物
拉线开关	电子
单少峰	艺术家
李宝珠	艺术家
王桂发	人物
王桂发	评剧
道义	汉语
立约	汉英词典
费启能	专家
盘水加剑	语言
袁克定	袁世凯
新晃侗族自治县	湖南
白沙黎族自治县	自治县
白沙黎族自治县	自治县
乐东黎族自治县	少数民族
关岭布依族苗族自治县	少数民族
松桃苗族自治县	少数民族
景东彝族自治县	地理
金平苗族瑶族傣族自治县	地理
金平苗族瑶族傣族自治县	自治县
峨山彝族自治县	云南
南涧彝族自治县	自治县
马炳元	人物
许有华	人物
何熙	历史
复合肥	科学技术
正太战役	解放战争
王君直	戏曲
王鸿兴	演员
保墒	名词
排位赛	赛车
多媒体电脑	电子计算机
新邵县	邵阳
狼吞虎咽	语言
津浦铁路	交通
宁雏	动漫
宁雏	同人
周大森	机械
王志生	艺术家
吴旗	地名
毛毡苔	药品
科第	社会
姜女庙	旅游
肖劲松	名人
勘察	词汇
嘎巴	解释
徐伯清	书法家
阎世铎	足球
徐斡	学者
赖彬文	人物
送风机	生活
电极电势	科学
乙酸	化学工业
伦敦证券交易所	股票
桂冠电力	股票
中国戏剧家协会	戏剧
赖经邦	人物
伍锡源	人物
飞鹤	品牌
刘达临	上海大学
iptime	网络设备
闵京勋	艺人
喜形于色	词语
飒爽英姿	语言
贺希文	烈士
安治泰	德国人
标的物	社会
去芜存菁	词汇
千灯镇	旅游
物力维艰	语文
伊利诺伊州	芝加哥
黄茂银	自杀
雅库茨克	西伯利亚
方捷	围棋
真州	历史
东北虎	动物学
下方	词典
王檄	围棋
李君凯	人物
金茜倩	围棋
陈兆峰	围棋
起皱	涂料
发电机	机械零件
高宠	宋朝
刘航英	作家
刘涓迅	文学家
氯化金	化合物
自强	汉语
平整	词语
叶宜津	人物
北长城	生活
金敏喜	女演员
朴永瓒	人物
塘坝	术语
安英吉	人物
韩钟振	人物
古雷	城镇
古杰拉特	地理
领头羊	证券
东海道	日本
羀	词汇
马云东	人才
弩弓	科学技术
同质多晶	化学
晶闸管	自然科学
巴厘海	海洋
晶体学	自然科学
李俊学	人物
安祚永	人物
权景言	人物
高在熙	韩国
府邸	词汇
藻酸双酯钠	医学
重力基点	重力
艾维	地球物理
逞工炫巧	成语
陈醋	词语
称量	科学
矫国更俗	语言
金闺国士	词典
九故十亲	词典
浅仓南	动漫
宫绦	汉服
麻凤海	教育
田福祥	青岛
谭继文	青岛
王斌修	青岛
陆游	著名作家
书院门	旅游
田永善	人物
林汲泉	济南
方长春	名人
叶国兵	江西
斯福民	人物
安珍清	人物
文昌鸡	烹饪
米醋	饮食
高声	文化
布格河	河流
资质	汉语
养血安神片	生物
马自达	比亚迪
金佛山	地理
阳炎座	影视
丙氨酸	科学
朱草	词汇
朱草	典故
娴熟	解词
帝休	典故
田景瑞	大学
拉卜楞寺	文化
凤片粉	淀粉
布莱克浦	地名
徐念慈	文学家
桂笃	棋手
辣妹子	歌曲
金角	西游记
定西	甘肃
米扁虫	科学
忤逆	词语
抿	中文
段银莹	古筝
投票率	选举
三节	文化
二老	词汇
班图人	民族
中国教育电视台	考试
黄世泽	香港中文大学
布埃纳文图拉	地名
贾客词	唐诗
江苏省美术馆	艺术
牧麻草	词汇
酆都大帝	道教
渣滓	词语
西崎公园	文化
杜学东	济南
杜红超	互联网
灯火管制	汉语
治安管理	汉语
斯图尔特岛	新西兰
种姓	民俗
庞元帅	道教
内日峰	山脉
中立区	地区
崔执凤	物理
搭手	词语
国鸟	民俗
盖棺事定	成语
鵼	汉字
刘增新	文学家
刘兆淮	作家
邝剑平	文学家
吉学霈	著名作家
石针	医学
石针	历史
生津	科学
厉志海	官员
楼阳生	政协
葛红林	人物
中国言实出版社	社会
中国戏剧出版社	文化
河东勋	演员
本田幸子	围棋
彐	中国
赵欣培	西游记
太康剑	文化
套现	经济
郑金岩	艺术家
岁序	词源
白庚延	中国画
刘泉义	国画
郭万清	人大
望诊	应用科学
景初	曹魏
生理需要	科学
王炜钰	人物
李仁荣	文学
惠普	电脑
佩刀	词汇
樊廉欣	文学
屈服应力	物理化学
黥	语言
电脑游戏	网络游戏
白石裕	体育人物
柴米油盐	词典
软饭	术语
过大年	词汇
车尘马足	成语
邪气	词汇
晨参暮礼	文学
见外	词语
控制元件	物理学
控制元件	船舶
中苏拉威西省	印度尼西亚
贝永	地方
贝沙尔	地名
透雨	文学
范雪朋	江苏人
樊城区	地理
饮食疗法	饮食
饮食疗法	应用科学
成帮结队	文化
成家立计	语言
黄初	三国
光熙	年号
潘培铭	文学家
贝桑松	地理
贝林加	地方
林文月	翻译家
波纹	化工
李桂平	教授
懒汉	词汇
江汉平原	汉江
半索动物	生物学
萨勒河	自然地理
鄂木河	俄罗斯
鲁山县	河南
袒	汉字
余欣荣	人物
减少	物理学
凝结	物理
张竞强	葫芦岛
际地蟠天	文化
传热系数	机械
成团打块	词典
教研	研究
亚美尼亚人	人种
玄青	词语
卫气	应用科学
卓而不群	典故
苏迪曼杯	体育
随机误差	理论物理
正光	体育人物
杰斯纳河	水域
杰赫勒姆河	地理
厚禄高官	典故
陈淑珍	盘锦
欧石楠	国花
对偶句	诗词
对偶句	修辞
垃圾箱	卫生
天疱疮	医学
输出设备	科学
共聚物	科学
带宽	信息论
骗人	中国
阿柏蛇	人物
白淫	疾病
神化	文化
乌法	河港
参议院	政治
施永青	名人
董君舒	人物
刘上洋	江西
勾云法	国画
乌斯河	旅游
疑凶	惊悚片
峰度	经济
玄胡散	应用科学
蔡治忠	人物
蔡治忠	历史
虚无假设	经济
虚无假设	社会科学
鸡血	中药
跨国企业	高新技术
市政	政治
乳糜	自然科学
初始化	应用科学
新石器	游戏
上海动物园	上海
韩开富	湖北人
番禺区	地理
蒙河	自然地理
迟疑不定	语言
大江网	江西
黎维新	作家
稗官小说	文化
小兔子	网络安全
血盆大口	法国
行李	生活
西峰区	地理
尺板斗食	语言
邢荣勤	著名作家
究诘	词汇
桂胜	古典
浣溪沙	文学
薛寿先	作家
督抚	官制
薛家柱	作家
中国共产党	毛泽东
桑克	现代诗歌
木朵	诗人
通心粉	生活
表面温度	能源科学
组团社	导游
冲州过府	语言
北陆	西晋
法施	宗教
双棘龙	古生物
软化	自然
崇墉百雉	词汇
谢付亮	实业家
夨	生僻字
王昭耀	共产党员
周玉蔻	人物
出口伤人	成语
错那县	县
中子源	理论物理
出乎预料	成语
出内之吝	成语词典
出奇取胜	词典
局域网	应用科学
天一阁	艺术
出奇致胜	文字
出师有名	语言
出世离群	成语词典
圣马力诺	欧洲
冷却水	能源科学
格栅	生物化学
白纸坊	社会
颜恝	名人
戈人	人物
乃公	称谓
路孔镇	地理
玄府	人体
透明性	物理化学
杨春鹏	教授
明装	采暖
火炬计划	经济
iebook	杂志
简阳	县级市
独创性	版权
印痕	词源
双语	心理学
徐标新	艺术
王洪君	名人
王筱芸	人物
暂降	系统
暂升	电力
暂升	科学技术
牛龙菲	人物
盖欧卡	口袋妖怪
刘迎胜	新疆
孙映逵	学者
蒲岐镇	乡镇
陆俭明	语言学家
幕友	职称
性质	分子生物学
大姑子	称谓
宿府	文学
科试	考试
久治县	地理
发卡行	经济学
小璜镇	江西
必胜客	生活
吴起镇	长征
蒋雨墨	人物
房开江	人物
筵席税	金融
仍然	词典
大埠东	村
布泉	北周
克雷姆斯	奥地利
徐之范	人物
方佩龙	革命烈士
卓泽渊	教授
排气	科学
疲劳极限	制造
涅瓦河	自然资源
忚	汉字
忚	词汇
特拉华河	河流
卡巴迪	体育
南宁站	交通
云爆弹	兵器
徐润之	医学
徐道度	人物
徐大桂	医学
铁电体	化学
碘钨灯	物理
匀整	词语
白无常	西游记
展旗峰	浙江
触处机来	成语
触景伤怀	文化
相容性	物理化学
颍川	地理
燤	汉字
茢	字典
桃酥	特色小吃
厘	汉语
邓金龙	革命烈士
攀缘植物	应用科学
太阳线	紫砂
灯台	古典家具
小舍儿	红楼梦
奥菲	影视
道姑	人文
道里	解释
治所	行政
刘尚任	共产党员
刘石柱	名人
农郊	词语
石户农	词汇
农奴主	词语
李剑铭	博士
花账	西游记
许云峰	人物
龙安志	人物
亚音速	自然科学
叶佳修	音乐
画框	艺术
刘希冬	理事
吴大同	人物
地砖	家居
皇姑区	辽宁
皇姑区	沈阳
尤老娘	人物
比肩	命理
文士剑	三国
沙狐	哺乳纲
明间	建筑学
金谷镇	泉州
卫长公主	西汉
李绍泉	名人
林邦彦	领导
李庆瑞	简历
马魁	文学
侯孝康	文学
丁济万	人物
滑脱	地球科学
滑脱	地质学
曲博	技术
徐名秋	人物
话别	汉语
李景熙	人物
威尼斯队	意大利
欢歌	词语
欢笑	词典
胡老爷	人物
绿豆芽	卫生保健
石槽镇	乡镇
火井	地理
昌元庆	人物
昌文贵	明代
指供	汉语
指责	词典
肠激酶	科学
傅秋芳	红楼梦
声控	词典
声谱	物理学
声腔	术语
娤	生僻字
胆固醇	分子生物学
红曲米	粮食
编程序	成语
古春明	会计
陈光虎	人物
关长征	党员
关永吉	会计
刘英麟	会员
主段	科学
舒芬	人物
刘有贵	共产党员
刘有贵	艺术家
刘振哲	教师
三聚氰胺	乳制品
学派	词汇
刘正波	名人
刘正维	教育
电感线圈	能源科学
缓气	汉语
幻化	词典
陈瑞章	烈士
邓志强	简介
晓鼠	新生代
陈皓文	科学家
支配	词语
去就	汉语
陈洪冶	名人
孙路弘	讲师
神公寨	湖南
张芝庭	人物
贾琛	红楼梦
贾敦	红楼梦
道谛	文化
熊长贵	社会
木佛	宗教
荒寒	词语
讥刺	词汇
张可盈	艺人
郝春轩	会计
酒鬼	股票
侯长荣	艺人
类似	分子生物学
助手	词语
助威	词语
桩子	成语
红陶	工艺美术
姚剑云	人物
乳糖酶	词汇
冷旭日	教师
何金海	人物
圣战手镯	网络游戏
裂殖	生物学
陈惠勇	名人
范武德	官员
刘宗久	艺术家
刘宗玺	名人
积存	汉语
最佳	词汇
赤道面	术语
医案	词典
医德	汉语
静神	文学
连建伟	医学
遗漏	词语
泽泉乡	星子
泽泉乡	江西
于远忠	教授
宿愿	词典
樱井翔	人物
杨新林	领导
天红镇	乡镇
门楣	艺术
贾玉玺	会计
兰彩风	陕西
钟丽轩	女性
承运	外贸
地羊鹊	中药学
禄庄	文化
关英楠	田径
马葭	明星
月亮泡	水库
礼无不答	语言
冷酷无情	成语
686	通讯
西黄寺	旅游
霍尔姆	运动员
黄乐	田径运动
英格博格	田径运动
鲜于辅	将军
康利诺	医学
当头	词语
北洋大学	天津大学
招供	词汇
招集	词句
招揽	词汇
招领	汉语
招请	词语
罗士琳	教育家
激切	汉语
极刑	词汇
刘桂敏	名人
刘怀玉	教授
黄素馨	生物
尼穆莱	城镇
卢庆春	脑瘫
农运	词汇
露馅	词汇
林学敏	辽宁
柳力耘	人物
投其所好	文化
化腐朽为神奇	文化
鬃毛	文化
退路	词典
程庄贞	人物
林玉兴	人物
周伯生	软件工程
吴理真	人物
车悬	军事史
马欢岛	南海诸岛
巴克科斯	文化
掰腕子	词语
冰雷	网络游戏
陈金飞	明星
柴宝成	名人
蔡其瑞	人物
包宗业	名人
谷开来	名人
谷开来	社科
西武狮	体育
殊荣	词典
圆周	术语
周彰	语言
周内	词语
卢克焕	人物
吕纯海	会计
萧端蒙	名人
卢焕昌	教师
卢世明	科学家
急智	汉英词典
弧菌	药品
黄任	诗人
等压过程	自然科学
鱼龙	爬行动物
茅焦	齐国
吴兴郡	地名
田宝臣	人物
培训中心	就业
舌桥不下	文化
粗线期	自然科学
谭家玲	简历
醉翁	政治家
陈明逊	书画家
几希	汉英词典
几多	词汇
挤出	自然科学
计策	汉语
本文	经济
记恨	词语
记载	名词
孟连傣族拉祜族佤族自治县	县
矮矮胖胖	成语
小帽	社会
注视	词语
莫里森	足球明星
梅南迪	田径
缺失	生物化学
金枪人	电影
特加特	运动员
王德显	马拉松
严剑葵	人物
张小雨	田径
张淑晶	人物
赵莹莹	田径运动
傣历	文化遗产
花厅镇	江西
复原	魔术
南丹县	中国
薛勤学	科长
薛夫彬	教授
马迎新	辽宁
马献军	河南
加斯佩	地名
陈金声	人物
圣洛	城市
全民教育	名词
汪村乡	地理
李景芝	科学家
王林超	人物
张群生	人大
陵水黎族自治县	地理
裴梅镇	乡镇
宋恩华	简历
军棋	棋牌
3448	病毒
杨汉生	广东
无盛盛	医学
马瑞山	主任
杨业	北宋
马荣超	主任
穆江	会计
加剧	词语
加剧	词汇
加以	词语
佳作	词语
家常	词汇
高致嵩	抗日
人防	国防
申大忠	教师
新居	词语
戡乱	词语
米德兰	河港
舒序本	出版物
均匀分布	数学
袁幕华	人物
南岩镇	乡镇
潘天耕	人物
冯默风	金庸
叶亚来	人物
陈本正	人物
嘉勉	汉英词典
嘉尚	时尚
假定	汉英词典
假定	药品
礊	汉语
边值问题	数学
赵可夫	生物学
侯福林	教师
王震中	山东师范大学
李志浦	名人
吉佳姆	民族
廉锦枫	曲目
威尔士	地区
宁陵国	诸侯
齐万春	辽宁
钱淑贤	大连
据高临下	汉语
据高临下	文化
奸贼	汉英词典
尖刻	词汇
中景	艺术
白节	蒙古族
艾弥尔	历史
壮年	节日
敬牛节	生活
游冬	中药
白灵芝	卫生保健
紫灵芝	自然
钟马田	人物
亚麻酸	生物学
两会	术语
丁咯地尔	医学
侯晶晶	女性
海捷亚	西药
谭耀文	名人
郑新奇	教师
王传奎	物理学
王传奎	教授
王汶成	教授
郑训佐	教师
廖群	学者
郑春	学者
叶雅各	学者
秋口镇	鄱阳
秋口镇	乡镇
全兆斌	人物
邵新民	人物
牟麦	本草纲目
牟麦	卫生保健
张燕根	雕塑家
间隙	语言学
兼差	汉语
秅	汉字
秋丹石	中药
晚上	时间
屏南县	地理
霍建宁	工商管理
霍建宁	华人
讳饰	文学
卫长公主	人物
旱涝保收	成语
清州镇	地理
杨府山	地名
胃脘	医疗
凤冈镇	地理
章良能	人物
罗椅	诗歌
暴走鞋	经济
拓跋焘	北魏
捡拾	词汇
减弱	生物化学
减弱	科学
减速	词语
减缩	词汇
萱花椿树	典故
剪径	词汇
悬车告老	文学
雪窑冰天	文化
学如登山	典故
石汝锷	人物
石月平	辽宁
阿联	人物
脱漆剂	化学工业
味如嚼蜡	文化
符美芸	歌手
印模	佛教
汪德耀	科学
jansport	名牌
黄秋燕	演员
孙一萍	山东大学
金陵饭店	酒店
王汝辉	创业
樱朱音	日本
湛河区	地理
冷咖啡	唱片
郑集	化学家
见得	汉英词典
蔡逸涛	用户名
东北虎	虎
花黄	美容
陈朝富	烈士
陈纯一	人物
陈伯诚	人物
陈伯诚	烈士
武邑县	河北
克仑特罗	平喘药
株潭镇	乡镇
禄田	历史
肺腑	词汇
巨雷	墨子
时梅萍	人物
催青	生物
性腺	分子生物学
性腺	科学
宋立斌	辽宁
宋瑞锦	浙江
龙澍峪	风景区
南北湖	旅游
莫氏庄园	生活
陈德兰	烈士
陈丹池	共产党员
陈大机	烈士
凌昌全	人物
房角	眼科学
玉果	应用科学
777	手机
李锦梅	人物
祝庆英	翻译家
超然不群	语言
剑眉	词汇
贱物	汉英词典
健在	词汇
健壮	汉语
黄士俊	人物
黄文田	人物
苏志佳	公务员
曾同春	海南大学
卡尼丁	医学
殷永泉	山东大学
张效民	教师
高宝玉	教授
解惠清	新人
王兴元	教授
陈仕伟	烈士
潘爱玲	高等教育
陈伟勋	人物
杨逢华	学校
三卫	词语
山谦之	人物
辛迪	诗人
专美	文学
专线	电子
芒古	越南
主攻	语言
主粮	粮食
孙渡镇	地理
文经武略	文化
翕然	词语
纳瓦伊	人物
糊化	化学
梁伟发	热点新闻
单色光	生物化学
卡力	科学
家公	词语
家公	词典
王审知	人物
丁荣贵	教师
胡维诚	山东大学
幸甚	语文
浆洗	词汇
浆液	自然科学
僵木	词汇
僵直	分子生物学
僵滞	词语
讲道	词汇
金功发	特级教师
连晓	词语
朱望阳	教师
豆卷	医药学
徐星伯	名人
林秋萍	冠军
韦宙	人物
兰钦	中国
郑虎臣	人物
币帛	词语
赵廷臣	清朝
降幂	三角函数
砚山县	地理
麻栗坡县	云南
达曼	地理
孙绍奇	人物
凤庆县	旅游
边罪	社会
勐腊县	县
黄中岳	人物
黄图必	人物
徐从高	山东大学
毕研文	教授
矢尽兵穷	文化
五陵	小说
王钟岳	江苏
抵死谩生	词汇
电子干扰	电子技术
王文鼎	名医
补报	词典
台资	词语
姚圩镇	乡镇
河下镇	江西
王普耀	清代
交恶	词语
alg	电脑病毒
汤治国	经销商
交替	社会科学
交谊	汉英词典
亚速	城市
军谘府	职业
宋武剑	人物
邢良忠	官员
张放平	人物
唐会忠	政治
蛇绿岩	自然科学
吴后义	知道
聚乙二醇	药理学
丁新民	总裁
柯帮诅咒	益智
郑旭煦	教育
财政危机	财务会计
血渍	词典
敛衽	汉英词典
中性词	语文
一碗水	卫生保健
交账	汉语
清诗铎	诗词
亚氯酸钠	化工
焦烂	汉英词典
焦烂	汉语
焦炙	汉英词典
焦灼	汉语
狡赖	汉英词典
绞缢	酷刑
田永康	四川
田志高	医师
佟柏山	辽宁
穆民	历史
佟太平	人物
贿买	汉语
罗扰素	药品
黄选平	人物
顽癣	医疗
耿贵立	教师
息交绝游	汉语
王新洪	山东大学
袭以成俗	成语
花鼓舞	节日
红素	自然科学
木雀舞	民俗
安昭舞	艺术
奥尔堡	丹麦
完骨	穴位
正月初二	风俗
腊鼓	春节
冗词赘句	语言
九亭镇	生活
安塘乡	江西
共振吸收	自然科学
韶口乡	乡镇
伦帕河	河流
伊丹	日本
伊东	地理
伊万里	地名
伊万里	日本
伊西翁	地名
杜生镇	玻璃
纸房头	沧州市
搅混	汉英词典
缴枪	词汇
叫做	汉英词典
叫做	汉语
庄荣文	人物
牛纪刚	福建
龚清概	市长
熊大木	人物
马新武	教授
散热	生理学
塔察儿	历史
张晓卿	华侨
张虔生	人物
张家瑞	孙中山
曾屿	诗人
甘洛乡	吉安
明溪县	县市
华南区	中国
韩学山	教授
栾兆文	教授
明经筵	皇帝
孙小红	小说
接唱	词汇
接防	词语
接近	生物化学
苏迟	人物
苏符	人物
苏峤	南宋
伯瑞犬	宠物
李英勋	韩国
包蒙	词汇
云程万里	语言
黄尖笋	饮食
高开低走	股票
曾孙女	国学
核威胁	第二次世界大战
泛读	词语
泛读	词典
悲风	汉语
悲风	辞海
静电计	通信
何罗	神话
接谈	汉语
揭发	词语
半导体器件	名词
陈应芬	人物
陈荫南	烈士
葡萄沟	新疆
单倍性	生物学
潘祥林	学者
傅余芹	人物
曲律	曲艺
陈荫林	人物
邵弥	人物
刑措不用	文化
备品	汉语
阳樊	地区
养国	历史
杨商卿	历史
李润美	明星
崆峒区	地理
实测	词语
实弹	词典
实弹	词语
实施	国学
实行	词语
实则	词汇
实战	兵法
李逸平	官员
曹文诏	军事
病病殃殃	词典
旧仇宿怨	文学
木剌夷	伊斯兰教
摩苏尔	文化
节片	自然科学
结伴	词语
于德辅	书法家
乐力	药理学
乐力	产科
吴太璜	医学
虚度	词汇
虚怀	词典
虚设	词典
虚诈	词汇
怯声怯气	成语
箳	汉字
吉云楼	故宫
哈维湾	地理
不名数	定义
肥力高	科学技术
陈四文	文艺
状况	词汇
沙与沫	艺术
子敏	著名作家
邵氏兄弟	公司
甘卓	战争
绘影绘声	文化
绘影绘声	语文
刺激性	词汇
刺破	词汇
刺伤	科学
刺痛	应用科学
刺啦	词汇
体念	词语
水解蛋白	医学
替莫唑胺	药理学
审读	国学
吵吵	词语
会众	语文
结业	词语
截尾	应用科学
阳桃根	草药
阴地蕨	中药
阴香皮	中药
苍华	词语
红鸾	命理
背不住	词源
背部	应用科学
背驰	汉语
何泾沙	学者
野兔	自然
池昌翰	朝鲜
王羚柔	人物
刘廷让	北宋
玩意儿	著名作家
八廓街	娱乐
养性斋	建筑
钟菌	生物
胡叟	北魏
寻杖	建筑材料
冥河	地理
实物地租	经济学
羊皮	草药
羊靥	中药
阿锡	典故
小农	经济
古汉语	语言
识得	词典
苏经宇	教师
编订	文学
编发	词语
编者	词汇
门肯	教育
解聘	词语
解散	词语
解吸	物理学
解吸	科学
阳德	地名
红统	地名
红统	城镇
新西兰人	民族
张国康	学者
相会	词汇
相间	词汇
相连	文学
相配	词语
相若	词典
相识	国学
栖息地	互联网
钟佐泓	音乐
吃干饭	词汇
搭伙	词典
饭袋	词语
界定	汉语
张棋惠	明星档案
界址	词语
郭民	学者
二垒手	体育
奥玛	宫崎骏
燕坊村	吉安
掷	动词
山植	医学
党的建设	社会
软体	计算机技术
粟良平	作家
紧俏	词语
毛青藓	自然
狐藉虎威	语言
袁世文	陶瓷
骨质	科学
爱脉朗	药理学
尽情	汉英词典
尽数	词语
劲吹	汉语
轩辕桥	桥梁
金盆庵	风景
夹山寺	寺庙
麻古	药品
徐德安	艺术
潣	汉字
俞藤属	植物学
过坛龙	中药
被开方数	科学
韩三平	导演
正多边形	自然科学
权宜	词语
繁殖行为	自然
近路	词语
近似值	词语
近于	词语
近缘	词汇
近支	词语
香面叶	自然
山楠	树木
两性花	生物
散兵	军事
陈屈	明星
耐酸性	科学
通力	佛教
灯光师	照明
泥沼	词典
守道安贫	词典
米喇印	历史
平杰三	政协委员
进奉	汉英词典
进谏	汉语
进爵	词语
进香	汉语
山球兰	生物
进站	词语
华平澜	人物
金属矿	生态环境
周恕义	高等教育
施云惠	学者
赚	字典
罗世生	人物
单斜晶系	结晶学
武怀让	特工
公屋	房地产
涟水县	江苏
涟水县	中国
旅差费	词语
旅费	词语
舟舆	汉语
文艺片	艺术
禁绝	词语
禁律	词汇
经办	词汇
马雪梅	教师
笔路	词语
杨方兴	人物
范时绶	清朝
蔡淳佳	人物
训政时期	历史
离析	应用科学
脒	自然科学
犁庭扫闾	汉语
俚歌	词语
沈唇	医学
后面	应用科学
倾角	机械工程
方进	江苏
方宝玲	教师
李文均	科学家
唐智慧	教师
正宁县	地理
王传银	美术师
元通镇	乡镇
南宝乡	地名
章庆国	医学博士
嵇璜	大臣
不问	词汇
历历	词语
历落	词语
历落	汉语
?	汉字
?	字典
?	文化
遗事	词汇
遗事	汉语
不正之风	文化
契合金兰	词汇
王维绪	官员
?	字典
?	汉字
?	字典
?	文化
?	汉语
焦特布尔	印度
翁叔元	大臣
吴熊光	人物
转台	文化
陶葆楷	人物
立雪	汉英词典
立誓	汉英词典
俪辞	汉语
心得体会	读书
华文出版社	编辑
aardvark	高科技
舌痛	应用科学
温忠	人物
蔡嘉	绘画
倊	汉字
鑁	汉字
葼	汉语
鯼	汉语
粽	汉字
机智问答	剧情片
塔科玛	美国
洛阿河	水文学
费赞	利比亚
半枝莲	自然
连任	文学
连日	词汇
连日	典故
连写	科学
联姻	汉英词典
刘将闾	人物
释延禅	武术
晏公镇	泾县
湛河	地理
奥尔沙	地理
薛逢春	人物
嘴唇	应用科学
采气	天然气
防尘	词汇
定向进化	生物学
修允	吴国
帝国主义	历史
不必	词汇
阳球	人物
张起政	名人
短诗	文学
穿透性	常识
王莹淑	教师
蔡国辉	教师
林性贻	教师
禌	文化
赼	字典
冯玉栋	教授
窧	字典
謶	汉语
奥帕瓦	地理
颜楷	成都
田颂尧	四川
郑寿全	四川
良医	词汇
凉津津	词语
宝川局	收藏
三八线	上甘岭战役
书馆	中国
唐大章	历史
其时	语文
础泣而雨	词汇
窡	文化
晫	字典
擆	文化
森塔	城市
王缵绪	四川人
林驹	人物
彭遵泗	诗人
樱花季	唱片
两便	词汇
两旁	词语
两讫	词汇
艂	生僻字
长殇	习俗
朋友圈	电影
面熟	日常用语
文籍先生	语言
姚之队	体育
清水湾	海南
郭宗汾	人物
两厢	词语
亮牌	汉英词典
亮闪闪	词语
量度	词语
量度	技术
大道	词语
鹿鼎公	小说
广播稿	广播
謌	汉字
泰伯公	周代
奥主	历史
黄定山	影视
古兰学	宗教
蒂米什瓦拉	地名
金爱武	人物
博克斯堡	地名
博罗季诺	地名
香九龄	文学
程纪贤	名人
埭头	莆田
了不得	词语
了不得	汉英词典
料度	词汇
撂荒	词汇
列举	自然科学
葛乃康	人物
美国国家安全局	国防
庆幸	熟语
睡袋	居家
孔文森	人物
搷	文化
搷	字典
尭	汉字
屒	文字
嵷	汉字
机器人学	应用科学
赖德全	艺术品
鬣鬃	汉语
黲	语言
王隆夫	美术
琉	汉语
吴天麟	人物
缑崇喜	山西
伤气	疾病
奔走之友	语言
高树春	将军
阇梨	宗教
猁	汉字
陈厚义	教育
魏成富	人物
魏成富	教育
幆	字典
幋	文字
胡宝林	教育
帬	汉字
十三场	历史
另请高明	日常用语
任成波	人物
任德盛	名人
斯波义良	武将
毕来德	艺术
张立辰	国画家
郎森	艺术家
骆文冠	版画家
邱叶	环球小姐
罗拥军	名人
亮	词汇
关树文	人物
中馈乏人	成语词典
sccb	电子
自励	语言
关广志	国画
周赞衡	科学家
朱公瑾	人物
知心朋友	专辑
罗磊明	艺术家
萝卜汤	食疗
打破常规	成语
幸福树	中草药
鹿逊理	人物
刘家魁	文学家
咸润	佛教
临盆	词汇
临行	汉英词典
分甘同苦	汉语
福祜	语文
福祜	词汇
甜津津	解释
享福	词典
心甜	词语
寿梦	吴国
孟传柱	山东
冯集梧	人物
鬫	汉字
髠	汉语
逸事	词语
郑永芝	歌曲
陆琦	音乐
陆琦	内地
淋漓	汉英词典
卢英芬	版画家
录入	计算机
硅酸钾	钾盐
叶青青	主持人
粟山	临朐
毪	字典
写法	词语
新文	词典
韩金城	社会科学
均等分裂	科学
韩锐彬	人物
韩新君	语文
鹿齿	中草药
鹿耳翎	植物药
雷振中	油画
韩绪顺	人物
博博迪乌拉索	布基纳法索
山矾属	草本
会演	汉语
相位角	理论物理
旋转磁场	自然科学
友谊赛	词典
博西球	游戏
碰运气	游戏
饶有兴味	成语
羉	汉字
卢鸿逵	国画家
隆太成	雕塑家
裴新华	主持人
何昌浩	生物学
康铜	化学
陈其昌	人物
陈其昌	文学家
陈祖继	名人
膬	古汉语
分岐	宗教
刘子铸	人物
氯化石蜡	石油工业
刘永贤	名人
刘以慰	艺术家
斯塔福德	地理
特性阻抗	电力
景池	人物
钙长石	自然科学
骊珠	宝石
王金瑞	体育
陈家桥	著名作家
陈朝红	作家
贾兴安	名人
郭冬	学者
郭因	名人
维多利亚州	地理
激子	微电子学
西中文	人物
液相色谱仪	工业
液相色谱仪	建筑学
吕建刚	人物
website	技术
刘小伍	版画家
刘曦林	美术家
刘士忱	漫画家
刘诗东	名人
杀气	词语
西卫滩	南海
东礁	南海
十字街	交通
何健秋	工程师
无恙	解释
异端邪说	语文
河流补给	环境
黄宗勖	针灸
郭明伦	人物
郭澄清	文学家
郭慎娟	文学家
师子	词语
避其锐气	词典
桑枝灸	灸法
早期教育	教育
法纳	词汇
地图分类	自然科学
张飞营	景点
sovo	教育
清潭峰	安徽
丹井	旅游
冗笔	汉语
不吃	解释
曼萨	区划
曼托瓦	球队
怀进鹏	人物
泥人	收藏
刘临	人物
王陆	教授
中华人民共和国农业部	民政部
钱光培	人物
蒙巴纳斯	文化
蒙巴纳斯	旅游
生活费	语文
刘汉珍	民国
阿布西尔	文化遗产
张济华	教师
董德存	人物
刘进安	名人
刘建敏	艺术家
郭玉斌	黑龙江
葫芦依样	文学
铺路	词典
南冰洋	水体
透光镜	日用品
高小莉	名人
高小莉	学者
北川	绵阳
海相沉积	科学
胡天	词汇
戚晓杰	学者
陈学玺	人物
刘恒利	国画家
吴乃宪	人物
钱公辅	诗人
任之	人物
三部	术语
三百六十五节	医学
柳梦璃	游戏
藤甲兵	诸葛亮
打赌	汉语
薄荷醇	自然科学
松甲山	风景
软坚散结	应用科学
导热性	工业
钱铭怡	心理学
李景夏	将领
刘东京	油画家
天下父母	节目
蓄意	名言
张菱儿	专家
荆溪镇	地名
郎颖碑	文化
倡导	词汇
艺术冲动	社会科学
邵鹏飞	学者
侯福庆	人物
野山	艺术
麦芽糖酶	自然科学
挤砖机	机械
尚献甫	道士
王连庆	历史
鲍宗汉	将领
萨佩莱	地理
渭源县	地名
萨莱诺	意大利
姬发式	发式
萨利纳斯	加州
贾隐林	武将
高满政	将领
輭	汉语
戴清民	将军
罗典	人物
乳齿	医学
憨态可掬	文学
慧昙	佛教
慧岳	佛教
高敏夫	学者
凤头	花卉
古碑镇	乡镇
公信力	法律
肿瘤科	应用科学
安固	词典
花棒	林学
胡倬云	戏曲
郑依平	名人
田钟洛	学者
廖连贵	名人
色心	佛教
程方圆	主持
色蕴	信仰
双木	宗教
霍俊	铁路
梁如洁	国画家
梁平波	艺人
遗忘曲线	科学
边角	词汇
词频	科学
登山服	服装
瓜沥镇	萧山
扎兰	词语
麻秸	中药
席尔万	地理
宰勒坦	地理
宾夕法尼亚州	地名
失街亭	娱乐
诺拉	明星
诺萨斯	地理
朱川浩	革命烈士
林之翰	林氏家族
林润	林氏家族
周大康	人物
晋武公	春秋
采配	历史
文新兰	兰科
李哲生	艺术家
吴白龙	名人
赵明选	朝鲜人
切肤	艺术
龙之吻	娱乐
李云亭	国画家
穿鼻	词汇
温益	人物
彭绪洛	名人
埃兰迪尔	小说
颈部	昆虫学
颈动脉	生物学
林钟贵	林氏家族
严天铎	名人
陈体诚	名人
刘敬时	近代
商衍鎏	书法家
肤末支离	文化
钟林林	消防
睹著知微	成语
杨洁篪	人物
任作田	针灸
任贤斗	湖南
中报	古汉语
苯胺	自然科学
任大枢	医家
解夏草	词语
嘉容	词语
怡悦	词语
夏政	人物
东嘎寺	地理
曹轩宾	明星
乙醛酸	生物学
三氯生	生活
三氯生	经济
轻烧	物理化学
脚掌	词汇
波形蛋白	营养
封釉	交通
神态自若	词语
晶体蛋白	生物化学
德言	词汇
反革命	词汇
浮言	词典
盘龙七	葫芦科
黄冕堂	史学
爱尔巴桑	地名
时事	词典
泥古	词汇
聝	汉语
巴拉卡	人类
民和回族土族自治县	青海
周怡君	明星
乌当区	旅游
塣	汉字
妛	生僻字
梁振华	编剧
人口迁移	高新技术
饶进	人物
梅李	江苏
小峰城	城堡
偏房	语文
偏房	词语
驿亭	建筑
中兴通讯股份有限公司	电信
风凉	词汇
林鸿年	状元
许天虹	浙江
李潜夫	作家
雀目	应用科学
起电机	电学
起电机	实验
酱菜	江苏
冠盖	语文
免疫化学	自然科学
允许	科学
夏瑾	湖北人
薛有义	人物
薛明扬	名人
张立彬	领导
薛允洲	教育
贝珠衣	工业
作文网	写作
黄志敏	馆员
王克祥	解放军
猫头	中药
明晨	词典
邹石麟	清朝
陈卓宁	高等教育
魏小云	浙江
夏月润	艺术家
丘浚	人物
徐俭	将军
崔文升	历史
肯尼亚先令	货币
清阳	生理
刘混康	道教
镖	兵器
老少无欺	典故
孟速思	将军
萧同庆	导演
黄龙岩	景区
苏灵芝	历史
苏瑰	人物
苏瑰	进士
张尚龄	清代
郝冰	作家
重述	词典
详实	词汇
详审	词汇
炔雌醇	科学
beer	英文单词
吴亚明	人物
张铠	专家
刘胜邦	清朝
明目茶	中药
高墟镇	乡镇
周敬利	高等教育
欧阳星明	教师
沈煜清	名人
卡塔皮	龙珠
云何	释义
学如不及	词典
希松	汉语
盼	汉字
怕鬼有鬼	典故
富铁土	环境工程
陈杞柏	名人
子胥	词语
卢周来	学者
林倩萍	艺人
垫款	会计
阿好	语文
阿连	历史
人格特质	心理学
请安	词语
ccmexec	windows
贼眼	人物
青丁	医疗
巨力	股份公司
韦伯数	物理学
执意	词语
舜日尧年	文化
媰	汉字
櫢	汉字
贾向国	教授
上肢骨	科学
方额	词典
开建	词语
青年会	卫视
木威	词语
骹	汉字
金人超	教师
孙伟平	教师
西店镇	旅游
曹谷溪	作家
曹谷溪	文学家
曹宇翔	学者
正学	社会
江太生	安徽
中国科学院近代物理研究所	研究所
江裕华	人物
曹继铎	文学家
曹雨煤	名人
面型	生物
姜磊	山东
李敦甫	画家
周崇华	人物
秋溪	人文地理
洪君器	将领
钱养庶	明代
前顶	穴位
同保岩	景点
钛钢	机械零件
假撇清	语文
丙戌	天干
撞墙	汉语
何景熙	人物
牛泷草	中药
刘土光	人物
陈新山	人物
厦门海关	厦门
蓬江区	地理
己丑	地支
工具钢	机械零件
元古界	地质年代
庄秦	恐怖
楚秀园	公园
头彩	词典
水嬉	语文
鲢鱼	自然
嵇康	历史
嵇康	竹林七贤
总政	语文
胡如忠	人物
鞠秀礼	领导
气舍	医学
丙午	天干地支
北湾	地名
印彩霞	主持人
孙浩英	艺人
张文楚	教师
曹茂君	人物
范长军	高等教育
魏其侯	历史
粤海	辞源
乐艺	书籍
微分形式	数学
琴瑟不调	国学
海坛岛	地理
阴数	数字
蒋开儒	词作家
蒋吕昌	浙江
干涸	词语
伏彦	作家
金师傅	连锁
席桥镇	行政
轻质油	自然科学
如日方中	词汇
焦天伟	人物
有机玻璃	科学
蔡灿得	港台明星
蔡灿得	明星
张结海	教授
肌肽	科学
鵕	神话
萧岐	明史
范遥	金庸
张阁镇	商丘
蛇心佛口	成语
赦过宥罪	成语
李军山	学者
石人炳	学者
陈恢忠	高等教育
郑丹丹	学者
齐能之	医家
棉纤维	棉花
当世	词典
庄头	温州
鞭毛	自然科学
高秉江	高等教育
李思孟	高等教育
罗秉芬	学者
圆经	古兰经
秦晓晴	学者
麻什	生活
有我无人	文学
石硕	学者
螺丝起子	鸡尾酒
从新	语文
飞速	词典
龙椅	皇帝
王时中	历史
赵炳然	明史
徐少玮	人物
谢国安	摄影师
宿城区	江苏
付雄	副教授
平尧卿	人物
平希豫	人物
薛泽	人物
白浪河	旅游
轻生	词典
龚知敏	文学家
郑声公	郑国
魏襄王	战国
瑞奇	科学
顾森西	小说
郑宽中	人物
龚依群	作家
周孝正	社会学
人口素质	社会学
概率密度函数	机械
曹棘	人物
元符宫	社会
鲁渊	元朝
张春波	经济
观战	语文
赵万山	人物
嶢	字典
嶢	汉字
蒋宏杰	人物
俞灏明	演员
俞灏明	主持
田胜立	学者
上海虹桥国际机场	国际机场
洪宇宙	大陆
田柳镇	地名
苯加氢	石油工业
中国人民志愿军	社会
伦金兰	杂技
配分函数	科学
王宝河	河流
宋在胤	人物
梅付名	高等教育
莫婉玲	高等教育
航海家	手机软件
郑亨	合肥
刘建斌	长治
刘建斌	作家
界湖	地理
见性	社会
空间点阵	自然科学
拦污栅	设施
清污机	电力
何永泽	篆刻
团粒结构	农业
上盘	武术
何家庆	名人
练漂	染织
北京工商大学	社会
国民革命	历史
硫酸亚铁铵	科学
挹注	语文
焊条	生物化学
平山郁夫	日本
金学泉	作家
白长青	作家
黑穗病	生物化学
麦饵	农产品
麦黄	语文
麦黄	词汇
越吉	人物
时尚秀	时尚
喉塞音	发音
为难	词语
征辟	历史
旋涡泵	机械
gorush	星际争霸
杨柑镇	广东
鲁昭公	历史
鲁共公	历史
铵盐	自然科学
宋炀公	人物
真空地带	小说
学区	词汇
杨朱泪	语文
珠泪	语文
五结	佛学
许淇安	香港
施保昌	人物
喜乐	词语
红门宫	建筑
台甫	古文
自渎	科学
黑匣子	航天技术
李集	武汉
毕志伟	数学
白马股	证券
馔具	词典
散光	生活
乔丕忠	河海大学
中国科学院心理研究所	中科院
南鸟岛	日本
宣礼塔	宗教
石冰心	学者
羊昙	人物
绿酒	生活
宋慈	人物
张又君	作家
刘应状	人物
黄立群	高等教育
柴湾公园	公园
八番	语文
八番	社会
弯度	词典
胡景芳	学者
粪胆素	新陈代谢
柴璐	中央电视台
张永芳	歌手
宝藏	社会
胡泽君	司法部
机动性	科学
ㄈ	符号
ㄋ	汉语
保险箱	合金钢
估值	贸易
片面	词汇
挪动	词语
张乐军	人物
钠泵	生物
钠泵	生物化学
钠泵	能源科学
囊盖	科学
沙玉华	明星
邓关镇	四川
基本点	人文科学
平价	国际金融
双顶	金融
囊腺瘤	生物
贾桂花	戏剧
塔萨达	生活
王越古	体育人物
里拉	乐器
姚庭宝	学者
玉成桥	建筑
司马悔桥	建筑
ㄏ	符号
华天	混血
20088	乐队
减肥	生活
张有德	文学家
磕牙	词汇
琐言	词语
金母宫	历史
雷祖殿	道教
枕山负海	文化
枕戈饮胆	成语
解夏节	泰国
秋霞园	建筑
第6场	娱乐
梅歧乡	地名
谭秉云	志愿军
乌尔班	人物
寿鳕子	漫画家
靖洪文	高等教育
万凌霄	幸福
撒花	词汇
撒娇卖俏	成语
夹景	科学
尉犁县	新疆
巴楚县	县域
拜城县	县域
安德烈亚	人物
雷尼埃	拿破仑
杨维好	中国矿业大学
邬红娟	人物
鼠目麞头	词典
刘述先	人物
贺麟	人物
贺麟	清华大学
ㄨ	拼音
ㄦ	符号
鄂公堡	地理
塔儿山	旅游
普岭村	村
龚文生	农业
门市	词典
鱼香	生活
管理层	经济
桑瘿	中药
宛梆	艺术
高昭文	阳痿
三连冠	生活
铃木镇一	小提琴
铃木镇一	音乐教育
彭绮	历史
刘薰宇	贵阳
甲基	生物化学
张译	明星
童心未泯	成语
云之凡	表演
尿卟啉	生物
张守波	教育
格球山	农场
散学	词语
亿兆	文化
烷	分子生物学
胡煦	光山
张紫晨	人物
张雅文	官员
马丕瑶	历史
唐基明	人物
丧偶	词语
职业咨询	人才
山马蝗	植物药
金汇桥	城镇
泰日桥	上海
四团	赌博
李吉明	人物
燕庄公	历史
燕共公	诸侯
燕成公	战国
留滞	词语
临潭县	少数民族
砥节砺行	成语
什袭而藏	成语词典
温祥	名人
许侠夫	烈士
李桅	人物
英吉利海峡	欧洲
城郊区	河北
职业指导	教育
鲁坎	文学家
李维琦	语言学
仙龙镇	地理
邓景辉	香港
红豆饼	烹饪
糯米糕	烹饪
奥洛尼	文学
曹共公	春秋
谌德容	人物
高宗武	抗日战争
范厚明	学者
陈灵公	历史
田开疆	历史
左益	学者
中山纪念中学	中学
滕发样	人物
十一月份	雕像
邓晓力	博士
花名	词典
戴志坚	学者
许丽平	教师
邓泽球	教授
趹	文字
程蔚东	记者
董宏量	作家
荔城镇	地理
光导	应用科学
李大栓	工程师
李得新	人物
草垛	词典
裴桦	学者
珰	汉字
曲伟年	文学
战菁一	明星
麦凯乐	商业
麦凯乐	经济
蒋文兰	江苏人
叶梅新	人物
胃泌素	科学
周朝阳	艺术
喷涂机	涂装
内定	词汇
学非所用	成语
迹线	力学
贾登峪	风景
金邦平	安徽
房展	语文
教鞭	体育
坛洛镇	地理
埊	生僻字
一言	宗教
水蓼根	植物药
上海街	旺角
爱德基金会	组织
蔡桓公	春秋
谢毓法	作家
那马镇	广西
张健鹏	编辑
李延珩	学者
海虹	水产
解学智	经济
廖翊希	学者
斯洛文尼亚人	民族
王展旗	武警
巴代	人物
新泰	地理
美山姜	医学
宁武镇	地理
七品	官职
李家鼎	艺人
林迪安	人物
古辣镇	地理
汲竹书	古代文学
闵竹松	历史
梅村体	诗体
shania	人物
处理	机械
谢明洲	当代作家
卡考	德国
福塘乡	广西
李洪珍	人物
自费生	硕士
黄瓜山	景点
聂明宇	黑洞
文聘	人物
仲英	工作
沙子乡	广西
moodyz	av
戴炳	画家
戴沧林	篆刻家
王丽方	人物
傅泽	著名作家
唐湘冰	遵义
钟非饭	文化
范鸿龄	名人
木兰拳	体育
人才流动	人才
陈先勃	龙港
吕舟	高等教育
象散	物理学
花桥宫	遗址
钟萼草	玄参科
花里镇	乡镇
李建萃	人物
祝融殿	道教
吕惠生	无为
通花根	植物药
临澧县	地理
科尼岛	木马
宓为建	人物
李文察	人物
曾连荪	人物
戴有祺	社会
腾子京	古人
大水法	中国
泥螺	软体动物
杨威斗	书画
李宋	硕士
竑	温州人
长福岩	道观
一宗	宗教
于涛方	人物
ttma	音乐
转差率	传动
文本检索	科学
洪美香	娱乐
窦纳乐	人物
杨云恒	人物
林波荣	学者
杨天钧	学术
樟木头镇	广东
知识库	建筑学
刘霁爽	诗人
濮道兴	古代
濮森	名人
魏敬益	书家
魏清海	名人
自发	语文
李夏恩	人物
陶庙	乡镇
bratz	街头
玉翎燕	著名作家
魏时敏	古代
魏世仿	历史名人
流泻	词语
流泻	解释
密封圈	工业
兰亭镇	乡镇
蜂窝电话	电话
文艺理论	社会科学
野葛	灌木
贾拉拉巴德	城市
贾拉拉巴德	阿富汗
格尔维	地理
格赖茨	地理
莫斯塔尔	旅游
埃罗德	旅游
埃洛尔	地理
佐洛埃格塞格	匈牙利
湖头	地理
提法	词语
桑地诺	民族英雄
跨山压海	文化
劵	字典
经传	汉语
杞麓湖	云南
康笑胤	人物
紫百合	自然
中观	佛教
曹喜滨	哈尔滨工业大学
钟代胜	文化
魏尊杰	学者
单德彬	人物
头骨	医学
錽	字典
马爱农	儿童文学
醉墨	词汇
醉醺醺	词典
泡罩塔	词语
泡罩塔	科学
中站区	地名
阿伯尔	外国文学
陈玉全	人物
王芝泉	人物
麦瓦利	宗教
金啸虹	艺术家
刘敏庚	编剧
查尔斯敦	地理
巨山	交通
精悍	词语
闫牧夫	教师
精力	词语
胡津	高等教育
敬胜斋	宫殿
翟玉娟	人物
孙昌敏	韩国
龙芽	自然科学
糟心	词典
唐宝云	艺术
排版	平面设计
战枫	明晓溪
灵门	词汇
六宗	语文
沙拉湾	城镇
向士壁	名将
白大凤	生物
天泉	治疗学
法夫尼尔	传说
见风使帆	熟语
起早贪黑	成语
成群结党	成语
涂炭生灵	语言
性急口快	成语
两头三面	语言
井然	画家
儆戒	词语
三氯异氰尿酸	化学
王嘉大	锡剧
纳贿	词语
跑马	词语
日朘月削	词汇
科教	词汇
有向图	电子
于继来	学者
硅酸钙	科学
齐乃明	学者
泸定桥	生活
氨基甲酸酯	科学
宁佐	忍者
书香门户	文字
无相	宗教
支墩坝	应用科学
刘林华	高等教育
高甫生	学者
李忠富	教师
孟冬	月份
净赚	词语
径迹	自然科学
敬佩	词语
林区	地理学
齐泽克	斯洛文尼亚
玻色子	物理学
曹圣洁	宗教
望帝	人物
冷浸田	环境
侯少奎	昆曲
氟	分子生物学
氟	营养学
吴志攀	金融
李贵田	美术
摇晃	变形金刚
屠场	文化
朽腐	词汇
三校生	社会
索纳塔	现代
重武器	社会
谈振辉	人物
陆士桢	教育
经国之才	熟语
经验之谈	熟语
钟皿浪	军事家
韩俊伟	人物
境况	词语
曼陀罗花	植物学
静养	词语
旧梦	艺术
镜画	词语
迥然	词汇
窘况	汉语
乜水	方言
卡洛洛	单机
镂肝鉥肾	熟语
镂金铺翠	语言
高不成低不就	文学
高飞远翔	汉语
罗家衡	名人
梅小青	人物
王黎钦	学者
郝明晖	高等教育
应变计	建筑学
纠偏	汉语
久等	汉英词典
酒糟	词语
酒糟	植物药
路迪尔	文化
砂土	土地
麻双乡	乡镇
水田	土壤
泽覃乡	江西
白幼蒂	人物
男妓	职业
倾天	小说
红奴	红楼梦
郭贵春	学者
胆色素原	科学
肺动脉	医学
刘华才	人物
暖湿气流	自然现象
漫衍	古汉语
钱肃乐	明朝
旧迹	词汇
旧货	税法
柳堡	江苏省
邓之诚	教育
赫奇帕奇	科幻小说
地理分布	理论
姚念贻	配音员
斯波坎	地理
土地税	会计
华杜英	木本植物
蒋治	建德
拨号器	病毒
绵腐病	植物保护
读不舍手	熟语
极目迥望	熟语
盛连喜	教授
盲风涩雨	语言
盲人说象	文化
陈文江	兰州大学
广丰县	江西
信州区	地区
友坂理惠	明星
朴真熙	人物
王月珠	人物
王月珠	名人
冉启文	名人
救生	词语
救亡	词语
盘根问底	语言
塞哥维亚	西班牙
申祸无良	语言
水流云散	汉语
中国人民银行	国家机关
后悔药	词语
供认不讳	文学
加持	宗教
阎浮	佛教
孟维晓	人物
孙克宁	名人
京九铁路	交通
二心三意	文学
朱唇玉面	文学
铁板歌喉	成语
长才短驭	成语
镇宁布依族苗族自治县	自治县
欺压	汉语
截断众流	字典
适逢其时	成语
适居其反	文字
陈璇夫	人物
天卫十四	卫星
做鬼做神	典故
遥控车	红色警戒
成算在心	文字
桥粒	生物
丹心碧血	词汇
丹心碧血	语言
吊胆惊心	熟语
佛眼佛心	熟语
小区	科学
如切如磋	成语
马晋卿	人物
孔宪京	教师
色光	物理
茬口	土地
俱全	词语
倨傲	汉英词典
陈洪塘	人物
los	技术
宋德方	宗教
悔之无及	成语词典
脚忙手乱	语言
巢焚原燎	文化
久居人下	文字
邱振鲁	济南
不熟	词汇
叮嘱	词语
移缓就急	文化
兴利除弊	成语
混合农业	高新技术
宝诗龙	经济
渴者易饮	文字
雷暴云	自然科学
多核体	物质
郑喜华	人物
郑雅兰	人物
人地关系	土地
聚合	理论物理
聚合	科学
捐献	词汇
涓埃	词语
卷逃	词汇
风趣	词语
切理餍心	词汇
切理餍心	语言
天理良心	文学
违天害理	词语
再做道理	文字
钟玉兰	会计师
化皮	中草药
迸射	词源
黄药师	五行
道孚县	地理
杨婉仪	tvb
风火山	山峰
李钧龙	学者
离弦	词语
孙可望	军事
刘传三	宗教
通理	针灸
通间	治疗学
比例内项	科学
谢柏梁	人物
鸡眼	中药
鸡眼	健康
绝嗣	汉语
绝粒	词语
多样性	自然科学
逼肖	词语
逼债	语言
鼻子眼儿	词语
吴三公	龙泉
时令	词汇
丽史	爱情
胡恩燮	清代
森然	形容词
成何体统	词汇
周嘉谟	人物
斯凯奇	人物
邹逸江	教育
杜守林	文学家
梁芒	名人
姚若龙	台湾
梁兴晨	作家
生财	词汇
军垦	词汇
军书	汉语
军委	词语
军装	军人
李殿勋	官员
二氢叶酸	化学品
阿马拉	伊拉克
阿尔马	城市
梁剑华	名人
何仁	大连理工大学
党延忠	教授
刘则渊	教师
邓小燕	学者
隆武强	名人
俊雅	词语
清河桥	桥梁
暗处	人物
熊赣湘	人物
武国玲	教育
顾崇廉	台湾
陈安琪	tvb
闵一建	西安
梅卓	诗人
梁韵松	作家
梅斌	文学家
许兆焕	人物
许怀中	学者
投合	词汇
番来覆去	词汇
国际漫游	专辑
阿威罗	地名
阿马西亚	土耳其
帮帮忙	张靓颖
程国采	教授
势如水火	文学
语长心重	成语
焦念志	学者
佛兰德	地名
邓东皋	科学家
库鲁病	医学
便血	消化
吴凤柱	人物
leah	明星
谢诗茂	专家
绿叶成荫	词汇
贝氏体	金属加工
左安龙	股票
岩崩	地貌学
生物钟	应用科学
看清	词汇
扛长工	词汇
陈国藩	英雄
堂皇冠冕	成语词典
堂皇冠冕	语言
盛子潮	散文家
戴德明	审计
转化率	化学反应
拍卖人	经济学
蠹国病民	语言
蠹国残民	文化
戴五嫂	人物
戴奇	国画
恣凶稔恶	文字
陈少锐	人物
冯鉴强	人物
吴长有	教师
头屋乡	景点
平拱	应用科学
陈天育	学者
推拿学	医疗
普通车	交通
崔小田	名家
古崖居	文化
周春芽	艺术
邓凤祥	烈士
抗旱	词汇
抗灾	词汇
抗争	词语
樊明德	历史
离子源	电子
孵化率	自然科学
比分	体育
常贵田	明星
伍云召	小说
惨重	词典
五天	词汇
比手画脚	词语
钉死	语文
曾园山	专家
邹俊东	体育
柳濑嵩	著名作家
辛善宇	人物
宁仕斌	历史
科名	汉语
可悲	词语
苏开乐	教师
冷眼	汉英词典
徐延飞	运动员
阿博维尔	城镇
割恩断义	文化
约夫切夫	运动员
绥滨县	地理
交淡若水	文化
黄菀	中药
仍旧	语文
宽甸满族自治县	辽宁
公因式	数学
公因式	自然科学
陈北鸥	文学家
赵有广	文学家
余知温	世界名著
可信	汉英词典
渴睡	词汇
克复	汉英词典
姜孟之	小说家
邹铉	元朝
舵机	航海
朴正爱	女性
黄耀江	人物
大梅格	节肢动物
茅崎	地理
茅崎	城市
若开邦	地理
英帕尔	印度
信臣	古汉语
信实	语文
水积	病症
贡都拉	旅游
刻意	汉英词典
恪守	汉语
bravo	电视台
丛荣臣	工程师
杨美琦	艺术
何煌友	摄影家
施其生	教授
计取	词汇
潘文石	大熊猫
冬竹	禾本科
海波浪	唱片
慈照寺	文化
尤小刚	导演
陈玉彬	学者
陈先法	人物
孟竹	自然
腨	字典
垦复	词汇
子群	群论
李适宇	学者
张仁铎	人物
坦巴昆达	塞内加尔
杰钦	地名
疏勒县	地理
疏勒县	地名
拉韦纳	文化遗产
博洽	词汇
空文	词语
孔径	化学工程
孔径	电子
孔径	科学
司徒尚纪	教师
三角梅	物种
杂粮	营养学
静观默察	文化
庄前鼎	人物
导航器	桌面
金银花	药茶
观鸟	生活
应天从人	词汇
泪雨	现代诗
刘芳艳	人物
兰阳平原	平原
白饶	语文
赘言	语文
赘言	社会科学
执业	语文
初基	语文
初献	词典
小蓬竹	自然
口传	汉英词典
疏肝解郁	医疗
于佳宁	运动
邓芹英	教师
万一千	教师
李攻科	教师
李攻科	学者
吕树申	教师
何思谦	澳门
通用软件	计算机
腮腺	词语
谷立业	体育
贾孝忠	运动员
文坛	汉语
丰化寺	揭阳
普慧岩	旅游
叩击	汉语
叩石垦壤	文化
叩问	汉英词典
扣襻	汉英词典
枯焦	汉语
王辅一	著作
部院	社会
批斗	汉语
射电	科学
毛萼莓	蔷薇科
门维	篮球
无框画	装饰画
赋形	古汉语
迪凯特	美国
侯显	人物
缪寿守	球员
路璐	篮球
爆发星	词汇
林韶泓	篮球
冲破	词语
佘卫龙	教师
王占宇	陶瓷
郝树江	人物
张健国	教师
枯坐	汉英词典
哭丧棒	词语
苦境	词语
占陇镇	潮汕
里湖镇	潮汕
东陇镇	中国
妙龄	词典
漆叶	中药
商酌	词典
诸公	词典
程门雪	医学家
死不改悔	成语
死不悔改	文化
徐小圃	医家
死声淘气	文学
死样活气	典故
死中求活	成语
酷虐	汉英词典
夸奖	词汇
庞琼	教练
卐	术语
岑宝儿	明星
田镇镇	山东省
刘锦玲	港台明星
邢光第	湖北
年年岁岁	俗语
网路岗	软件
实地调查	语言学
周之翰	举人
古清生	著名作家
金天柱	人物
褚伍	词汇
王秉德	文学
铁中棠	文化
橡木	植物
兵工	军事
快意	汉语
快语	词语
宽打窄用	汉语
宽宏	词汇
儿郎	传统
马伶传	清代
幼儿期	社会科学
肾囊肿	生活
慕名而来	语言
持衡	语文
吴人杰	清代
崔尚斌	教师
崔尚斌	人物
范新友	解放军
款曲	词汇
特征方程	空间
钟秉林	博士
开封	旅游
英格力士	书籍
木卫六十三	宇宙
胡镇埔	人物
余云岫	名人
周诚浒	医学家
専	字典
旷费	汉英词典
旷废	汉语
柳斌杰	人物
柳斌杰	官员
范兴荣	人物
顾基发	科学
郭正林	教授
老干部	人物
单项工程	经济学
航图	词汇
蒋泉龙	财经
短视	词汇
瓦迪	人物
黔南布依族苗族自治州	贵州
高希钧	教育家
依违两可	语言
食窦	治疗学
侯祥川	医家
不谓	词汇
益处	词语
熔化热	科学
扩展	词汇
潘以溶	清代
周际华	清代
榖	汉语
沙皮犬	犬科
法扎巴德	城市
赫尔辛格	地名
福斯湾	地理
福拉尔贝格	地理
魏大振	清代
磨粉机	机械零件
姜容樵	人物
潘承孝	中国矿业大学
涂国林	湖南
童少生	人物
沈昆男	体育人物
冯公智	人物
刘彦斌	人物
曾荣光	人物
清盘	金融
筹备	文字
班建制	制度
马儒沛	人物
派购	历史
瞎抓	词语
括弧	汉英词典
拉不下脸	词汇
拉拢	文字
蜡白	词语
蜡黄	词语
苏元章	人物
董怀章	河南
中国气象科学研究院	科学
糕干	饮食
董明敏	人物
束手就困	成语
束手听命	成语
束手无术	语言
束缊举火	成语
束在高阁	语言
挹	词语
简切了当	词语
咸风蛋雨	语言
马贵镇	广东
黄金钟	举人
谭先召	贵州
谭先召	举人
富国学	经济学
曹振峰	名人
风速计	物理学
风速计	环境工程
来得早	词语
来年	汉英词典
来自	词语
董秀阁	医师
波克	地理
吴仲良	人物
乔薇	歌手
吴子彬	人物
吴之仁	体育人物
刘体智	人物
唐旺旺	名人
王荫嘉	江苏人
孙煜峰	名人
谢旦如	人物
迪乌夫	塞内加尔
迪乌夫	前锋
向雪怀	明星
陆德龙	举人
谢上选	人物
华檀梨	生物学
拽巷逻街	文化
点歌机	唱歌
家乐	股票
拦腰	汉语
阑槛	词语
马采	人物
李德恩	研究员
感觉器	人体
截镫留鞭	语言
孙寺镇	成武
陈清江	教育
国家中医药管理局	社团组织
正义网	互联网
单证员	结算
姆特瓦拉	旅游
陈冷	小说家
萧重望	人物
贾庆国	北京大学
歪点子	词汇
胸有成算	文学
棉子油	中药
威廉港	行政区
烂崽	汉语
滥交	汉英词典
郎当	词汇
浪游	词语
末期	临床医学
丁群明	台州
河北农业大学	中国大学
鸡不及凤	成语
英菲尼迪	交通
许绮玲	名人
哈奈根	地区
见卵求鸡	成语
见卵求鸡	词语
叶朝丐	人物
偷狗戏鸡	语文
周伟江	人物
谢卫星	市长
朱坤民	官员
超前绝后	熟语
超前绝后	文化
防患于未然	文化
天威保变	股票
哈伊马角	地理
杨遵	贵州
安万铨	人物
时代文艺出版社	文化
镪水	化学
超然绝俗	词典
超俗绝世	熟语
三贤	佛教
车围	词典
秋阳赋	苏轼
丁往道	英语
井台	江西
秦献公	秦朝
劳心	汉语
劳劳	汉英词典
老臣	名人
广州湾	湛江市
挠	语言
刘皓明	专家
老弟	词语
老古板	汉语
漫延	词典
钱讷仁	军医
鸟粪	食物
雷阿尔城	旅游
老爷子	词语
明媒正礼	典故
小升初	小学
盛血	生理学
獂	汉字
尼勃尔	基督教
刘根生	画家
尿嘧啶	自然科学
棍棒	词汇
宋柏年	人物
范野	人物
泪管	汉英词典
一师附小	教育
新罕布什尔州	池中玉
锡尔特	城市
谢元深	唐代
宋鼎	唐代
见机而行	字典
见风使船	成语
毛诗序	诗词
抵罪	语文
金纯	历史
莱城区	地理
解义	词汇
路德维希港	城市
宋万明	人物
杨轼	贵州
杨文贵	贵州
田佑恭	人物
冷凝	物理
佟凤彩	清代
累及	汉语
冷袖	汉语
安贤洙	冬奥会
楚金玲	球类运动
洪育沂	外语
高年生	外语
氮化硅	机械
灵海	语言
阎崇琚	人物
黄国祯	德语
箭毒	生物学
许真君	南昌
裴继伟	证券
董政	证券
千古不朽	中文
杨树勋	人物
木尔坦	古城
孙诵昭	艺术
孙诵昭	中国
王子铭	教授
商国君	文化史
车梁木	木本植物
周献桃	江苏人
潘鲁生	文学
冷僻	词语
冷冷清清	词语
冷冷淡淡	汉语
冷噤	汉英词典
愣住	词语
愣乎乎	词汇
梁勋学	书法家
西里尔	人物
周培	教授
尘垢	宗教
柯奂如	人物
赵五娘	人物
豆家镇	地理
弊病	名词
柏忠言	瑜伽
五营区	黑龙江
带岭区	行政
经互会	冷战
塞牙	卫生
王亚新	高等教育
余凌云	学者
书典	纪实文学
瘿瘤	农作物
花露	语文
蔡峻	微生物
pingco	聊天工具
专才	称谓
拉韦纳	地理
去日	诗词
徐正标	书法
墨汁	软体动物
淮阴区	地理
肖霖生	人物
邗江区	地理
结绮阁	建筑
武将	历史
深圳证券交易所	创业板
中华民族园	北京
张错	作家
年册	收藏
攻击行为	生态学
吴念乐	高等教育
李师群	高等教育
麻谷	毒品
基膜	科学
插架万轴	文字
赵雪芳	山西
饮子	词语
饮子	传统医学
伍儒	文化
伍遵契	宗教
李英村	人物
垦丁	地理
陈德朴	学者
李兆陇	人物
老老少少	成语
老师宿儒	成语
沈文冲	名人
何安达	作家
携老扶弱	成语
田子	文学家
郝仲术	作家
王孟云	书法家
妻儿老少	语言
游车河	歌曲
曹苏玲	党员
田州镇	广西
unsap	网络
洁身自爱	歌词
敬贤爱士	文化
水木亚丁	作曲家
水木亚丁	人物
子椒	战国
头盖骨	医学
孙芸芸	六人行
核苷酸	健康
冰期	自然科学
解驭珍	名人
胡侗清	航空
乌韦斯汗	文化
记忆系统	记忆
形象记忆	思维
甘雅丹	民歌
梦游症	健康
枢纽	汉语
马金虎	政府
薄子珏	艺人
霍亮	名人
霍奕	艺人
冀旭	名人
食古如鲠	成语
千古奇闻	成语
泥古非今	文化
王云谷	汕头
李基智	名人
尹彦辉	作家
鲍文清	作家
廖代谦	名人
廖洪球	画家
韩德洙	人物
樱大鉴	书籍
徐永杰	文学
求积仪	术语
宝生舞	人物
范咏戈	党员
情事	词典
胡志标	企业家
万托林	科学
黄堤镇	河南
车镇乡	地理
防己	应用科学
兰昊宇	我型我秀
数码港	香港
红薯	营养学
马伯庸	灵异
通根	五行
廖华强	名人
蔡子谔	摄影家
瓦伊赖	文化
任辅臣	无产阶级
佛堂	词汇
杨洛婷	艺人
鲁迅美术学院	教育
天津美术学院	天津
冬季运动	冬季
柏一	散文家
遗传信息	科学
病毒感染	科学
公选	词典
公言	语文
公映	语文
蔡宗周	名人
陆震华	美术家
宝钿刀	武器
曾实	高等教育
樊昱君	舞蹈
含辛忍苦	语言
基金裕华	经济
基金裕泽	股份公司
思召	历史
青黛眉	美容
党宪宗	诗人
陆爱英	文学家
青脚莲	中药
千百年眼	历史
香味	科学
张翊生	演员
整固	词典
朱棣	君主
李风宇	名人
轩锡明	作家
马泰泉	人物
易永畦	毛泽东
任惠中	人物
横峰侧岭	语言
橡胶管	自然科学
强心茶	医学
赵诗梦	模特
彩漂粉	洗涤剂
针芥之合	词语
德柯林	自然科学
陈吉宁	人物
瑶草琪花	语言
宗派主义	党史
丁天怀	学者
尚慧敏	人物
范乐新	京剧
郑雅风	画家
陈少云	歌手
杰拉德-华莱士	球星
戎昭军	地理
杨鸣玉	扬州
喘证	应用科学
白再荣	官吏
雅玉	人物
黄耿辛	艺术
快人快事	文化
赵敦华	教师
陶菲格	名词
刘富道	文学家
孙钿	作家
孙钿	文学家
吕明涛	文学家
赫维什州	城市
林功实	高等教育
顾立基	人物
阿魏	植物药
显密	社会
鲁毅智	人物
鲁毅智	金融
陈建海	教授
洗甲水	时尚
孽根祸胎	成语
梁开国	人物
陈龙正	历史
标准差	基金
姬壬臣	君主
欧耐农	湖南
白芷汤	烹饪
兰木乡	地理
泰克比尔	名词
熊伯齐	篆刻
林宥嘉	人物
姚大卫	学者
蔡小强	学者
鹅不食草	植物学
鹅不食草	植物药
鼠盗狗窃	中华文化
杨氏实验	物理
隿	生僻字
青桐	园林
木钵镇	乡镇
木钵镇	甘肃
航天遥感	地理
nod	英语单词
玉亭	石家庄
晏玉琮	空军
贵定县	城区
驱羊战狼	文化
羊狠狼贪	文学
国际联盟	社会
元侯	社会
柳羊洞	景点
古灵山	地理
焊料	无机化学
chinaz	互联网
车宏生	心理学
夏真	作家
靖谮庸回	语言
谢伟东	人物
陈诗来	名人
中场	橄榄球
封开县	地理
转座酶	生物化学
包囊	生物化学
孔繁定	台湾
肖忠党	学者
林昆	人物
玉竹茶	药茶
眼膜	美容
眼膜	应用科学
亲授	语文
表露	词典
黄昌华	散文家
刘康健	文学家
玉龙滩	生活
吴红良	书画家
土鸡瓦狗	语言
吴焯	作家
东园局	历史
夏敬校	华容
怫然不悦	成语
陶埙	文物
箕山之风	成语
摩周湖	湖泊
王光东	学者
寿司王子	连续剧
toshiya	人物
黄华河	水域
失掉	词语
云城区	广东
叶朵丽	影视
承天军	历史
非法行为	社会
鸷鸟	汉语
希腊文	语言
颜冠英	情景喜剧
维西县	少数民族
李恒瑞	文学家
任红举	名人
夙世冤家	汉语
白璎	小说
白璎	文化
修容	历史
管晓宏	人物
擦澡	词语
六十七	官吏
沙缴府	景点
龙荟丸	中药
乌泰	人物
清润丸	应用科学
肖金镇	地理
彩绘	建筑学
何占鳌	人物
辛郁	诗歌
大卫盾	文学
师敬学	文学家
林向群	人物
权万纪	历史
招风惹雨	语言
风凉话	故事
小家电	居家
自欺	科学
宁芜线	铁路
老店	剧情片
紫痕	剧情片
毕四海	著名作家
春风野火	汉语
火海刀山	文化
林有润	人物
柳孝图	高等教育
黄时枢	人物
以血还血	剧情片
王恒志	价格
白头洲	地理
曾建文	政治家
巫云楚雨	文化
华桔竹	生物
云奔雨骤	成语
代理服务器	应用科学
渗透率	电子技术
姬胡	周朝
生产井	石油工业
圣裔	圣人
洪世川	画家
符影杰	学者
孙小菡	高等教育
沉重寡言	成语
嗫嗫嚅嚅	文化
跌宕风流	成语
滚烫	语言
苯乙胺	科学
金炳华	作家
张鑫炎	中国
顾保孜	文学
体语	书法
体语	艺术
从容自如	文化
撒骚放屁	语言
贺浩	政府
仅此而已	寓言
扩增子	遗传学
刑具	古代史
白鹏飞	中国青年政治学院
徐清辉	名人
率尔成章	语言
旈	汉字
刘嘉福	演员
徐梦秋	红军
冀勤	名人
刘畅园	著名作家
韩天航	名人
于天文	人物
农冠品	名人
何玉茹	文学家
刘德魁	名人
孙香萍	武警
咽喉炎	耳鼻喉
噪声容限	电子
噪声容限	应用科学
养脾	卫生保健
同符合契	汉语
黄克秀	人物
二次开发	管理
勒拿河	旅游
周濯街	人物
白雪林	中国作家协会
李绪源	作家
周树山	中国作家协会
刘富民	天津
刘广球	人物
武学儒	名人
巴泽加	地理
耐用品	技术
古尔马	地名
夏力薪	新闻人物
牡鹿	生物
送去迎来	成语
去故就新	文化
邓耀明	人物
狐鼠之徒	成语
鼠目獐头	文化
盘活	词语
王铁锤	艺术家
温儒敏	文学家
薄竹	竹
光芒四射	典故
光芒四射	俗语
1814年	历史
石晶晶	人物
白养珍	人物
安谷镇	四川
慰唁	词语
双石铺	地域
协济	词典
石海军	学者
存续	词典
波尼	品牌
诐	汉字
鲁壁简	文明
事故	能源科学
费事	词汇
芥蓝	草本植物
郝爱平	艺术
追诉	法律
沙梦弼	宗教
法兴王	君主
任喜荣	宪法
莫比	明星
石珊珊	运动员
埃德罗	电脑
黄渠乡	甘肃
张道正	文学
风烛草露	成语
卢凤源	学者
砥节励行	词语
砥身砺行	语言
顺风使船	语言
荷兰文	语言
双拼	科学
王锰	书法
任万全	作曲家
安康计划	计划
李德瑞	书法家
金干运	君主
霍建波	名人
佩德森	人物
忆旧游	诗词
曹海炳	老兵
点金作铁	词汇
钿合金钗	典故
跌荡不拘	文字
来回票	词语
中国工商银行安徽省分行	银行
金塔镇	乡镇
康金声	山西
唐贝克	应用科学
服牛乘马	寓言
谭竣浩	明星
美尼斯	历史
东奔西逃	文化
周亚琴	学者
庞晓波	高等教育
于洪彦	学者
徐礼贵	人物
门小雷	作品
跃马扬鞭	典故
红白山	地理
中国国家男子足球队	中国
彭阳县	地名
施兆鹏	茶人
戒惧	词语
铁壁峰	旅游
点染	诗词
长生堂	老字号
侨兴	经济
梁振文	艺术
赌彩一掷	成语
风流倜傥	汉语
流动沙丘	地貌学
丛志先	高等教育
伍铁如	人物
柏灵	应用科学
水登	艺术家
执迷不反	文化
蒲犁国	地理
塞瓦布	阿拉伯语
频数	术语
惠明茶	生活
阿蓬江	景点
陈立清	人物
剖宫产	医院
尤邦孟	中国
王同庄	散打
夏令时	时区
夏令时	天文学
王殿海	人物
徐尚田	人物
劳动竞赛	人文科学
程廷华	八卦掌
许帼光	名医
奚伯初	医学
宁树恒	艺术
李庆绿	书画家
根目录	目录
司关	历史
司闺	官职
问官答花	语言
断落	词语
王静安	四川
断根绝种	语言
顿腹之言	文化
目光远大	寓言
中共中央北方局	政府
西顶	庙宇
木坑	自然景观
于吉红	高等教育
伎乐天	敦煌
胡旭东	作家
拈花弄月	文化
谢克庆	名医
小湖镇	福建
阐幽明微	文化
安巴尔省	伊拉克
米桑省	地理
薛媛	人物
遁世离群	词语
严玺	甘肃
王临友	书画家
王垠生	人物
参悟	词汇
王良学	文学家
兔女郎	女性
骑驴找驴	成语
识记	心理学
金钦汉	科学
郑致良	山东
旧恨新仇	成语
垂头塌翅	成语
郑士杰	名医
马汝珩	学者
罗贤佑	人物
梁一儒	人物
梁一儒	学者
王天雍	人物
横行逆施	语言
佩陶克	赞比亚
俞德渊	名人
司卫寺	官署
爱立信	经济
路德宗	社会
平龙	人物
司巫	社会
姜世梅	高等教育
杨子姗	人物
焦帅	运动员
焦帅	体育明星
翁守瑜	人物
埃达克岩	地质学
热量计	化学
瞪眼咋舌	语言
取经	词语
屈吴山	考古
张帝	台湾歌手
刘芳贵	人物
皮靴	民族服饰
赵志壮	学者
王怀基	艺术
道远知骥	文学
道合志同	成语
鲍步云	名人
鯷鱼	鱼类
鯷鱼	生物
聂桂林	清朝
巫支祁	汉语
邓明仲	名医
二乙烯三胺	化学
科多巴	足球明星
守方	词语
玄黄	神话
游客止步	电影
寿国寺	文化
气喘病	病理学
中岛沙树	动画
张军钊	中国
李葆嘉	人物
燕杰	画家
朱维民	书画家
萨仁花	人物
孙德良	电子商务
瘦人乐队	明星
羡	语言
李红袖	古龙
刘作斌	人物
建筑署	装修
董孝芳	人物
卢艳秋	高等教育
尚贡博	县
杨虑	人物
鬼工雷斧	文化
汉封乡	地理
郭玉良	人物
燕川乡	石家庄
冰柱雪车	成语
鉴影度形	词汇
践规踏矩	汉语
渐不可长	文化
渐不可长	文化
王久源	人物
张继业	山东
张万臣	艺术
查国华	作家
查国华	教授
查世超	名人
查有梁	名人
孙玉明	学者
孙玉明	半导体
孙玉明	人物
单正平	文学家
单正平	当代作家
刘永佶	人物
青化乡	地理
营头镇	地域
马中苏	人物
岁贡	社会
承节郎	历史
lafee	歌手
段俊国	名人
没法奈何	文化
没颠没倒	成语
冒名接脚	语言
进退无措	语言
秦商	商人
阿比丁	人物
姚巧云	艺术
白碌乡	行政
钱吉成	体育
姚俊中	艺术
议处	历史
心耳	解剖学
右军	职称
丝氨酸	化工
张兆坦	人物
力倍功半	中文
常聪	黑龙江人
郄建伟	国家
云窗月户	成语
汤溪河	重庆
秦伟平	高等教育
杨罕	高等教育
矜己自饰	文化
矜己自饰	语言
矜功负气	词语
矜功伐能	文化
津关险塞	成语
矜平躁释	词语
垂杨	地区
东挦西扯	文化
张通	新闻人物
鼠胶	词语
血清型	科学
血清型	自然科学
俞振林	人物
佩恩	动漫
维加斯	游戏
李秀岭	人物
曹枫	社会活动家
臧文仲	外交
邓志文	中国
马立诚	人物
东绵	企业
李丰田	书画家
双龙沟	新疆
韦恩图	数学
qunar	搜索
海角天隅	词语
海枯见底	词汇
酣痛淋漓	文化
含牙戴角	成语
母盘	网吧
李景兰	甘肃
正言	汉语
束传银	山东
恩断义绝	词汇
摵	汉字
襌	生僻字
南浔区	地理
伊迪雅	最终幻想
左建军	山东
王卫彬	利津
比莉妹妹	剧情片
叶学锋	人物
祁静一	宗教
日久月深	成语
铜围铁马	寓言
私家园林	生活
鼓风	科学技术
医宗金鉴	历史
华中师范大学	教授
柳鹏举	聊斋
王延镐	聊斋
余洒度	黄埔军校
谢承瑞	少将
跳棋	文化
锦丰镇	张家港
储备头寸	管理学
打封闭	治疗
遮天盖日	成语
unixtodos	编程
write	编程
intdos	函数
贫铀弹	军事
松冈充	音乐人
出息	词语
染织	工艺美术
阳光计划	孩子
阳光计划	自然科学
肉碱	词汇
世族	词语
刘鹤年	人物
张月胜	人物
玉川坝	建筑
姚奎英	人物
储永义	名人
厉恩海	人物
云层	事物
云层	气象
韩宝利	画家
管虎	明星
段文洋	哈尔滨工程大学
首山镇	地理
木卫六	自然科学
李长发	会计师
躬行	语文
邢以群	名人
余十眉	嘉兴
犯罪团伙	小说
金淳兆	人物
欧阳丹彤	人物
董大	艺术
沙扒镇	地理
张春盛	山东
皮曼河	水业
丛广滋	摄影家
丛万新	名人
用具	汉语
曹坪镇	陕西
曾有英	广州军区
湖流	水资源
男人河	剧情片
斅	生僻字
潘承弼	文化
傅学正	人物
吴恒泰	人物
张著权	书法家
徐乐吾	玄学
徐彻	文化
吴同芝	人物
纪德修	人物
杨佩衡	人物
陈定家	文学家
侵扰	科学
延坪乡	陕西
吉文贞	曲艺
王淑凝	陶瓷
发酵罐	科学
蔡吉人	科学家
马京生	军旅
杨志麟	书画家
聚四氟乙烯	药品
罗森博格	足球
成都体育中心	足球
苦水镇	乡镇
苦水镇	地理
gon	语言
袁崇水	山东
蟮	汉字
轤	字典
乌尤寺	历史
历日旷久	成语
黄嘉树	人物
饿殍	汉语
李言荣	教育
洪天照	人物
十四行诗	艺术
野战	运动
阿尔贝维尔	地理
何虎臣	永登县
唐古特	西夏
苟宗碧	重庆人
廖海黎	名师
沈锐利	专家
季胜	人物
二对半	乙肝
nismo	日产
陈朝生	书画家
罗拯	实业家
延载	武则天
韦营乡	甘肃
太乙真人	道教
罗森海姆	城市
沥青路面	建筑
毛建儒	人物
视觉暂留	科学
其加达瓦	艺术
家常饼	生活
蔡敦成	名人
边棱音	自然科学
甘惠廷	甘肃
温朱万	人物
朱美丽	戏剧
朱美丽	演员
傅秉常	政要
金问泗	人物
刘驭万	外交官
是非颠倒	语言
乔甸镇	云南省
刘俊国	山东
薄其恩	利津
车鹏飞	油画
童衍方	篆刻家
焦金海	古筝
刘竹生	院士
王音睿	音乐
程守民	利津
光照阶段	生物
燕崖乡	沂源
翻卷	汉语
公库	银行
公库	金融
最高点	新加坡
钟维	人物
袁鸿化	人物
王立人	人物
云山观	旅游
金甲兽	娱乐
金甲兽	怪物
昌列寺	寺庙
宗女	家族
刘蓉华	人物
燕支	武器
褚师	职称
宵旰图治	文化
骨殖	语文
李碧乐	学者
中国残疾人体育协会	残疾人
中国残疾人体育协会	残奥会
姚文贵	高等教育
燕兴	中国
