成奎安	人物
提琴	乐器
郑麟趾	学者
霍去病	名将
氢	原子
波司登	品牌
刘品言	艺人
没药	中药
刘怡涛	人物
吴月霖	人物
谭维维	明星
大兴安岭	山脉
许地山	人物
通用汽车公司	公司
新论	著作
北沙参	中草药
安远	地方
图们江	水域
王祥夫	人物
罗贯生	人物
鲨	生物
齐纳曼	人物
罗镜泉	人物
马役军	人物
枫树	植物
俞沙丁	人物
马光复	人物
干尸	文物
中南大学	学校
城门	建筑
鱼腰	穴位
任钧	人物
骨囊肿	疾病
牛筋草	杂草
高罗佩	人物
任率英	人物
任溶溶	人物
曾巩	苏轼
金玉湘	人物
栾明贤	人物
新店溪	河流
贝纳通	品牌
穆孝天	人物
莫砺锋	人物
朴志胤	演员
美女樱	观赏植物
赤霉菌	真菌
香溪	风景区
刘振夏	人物
康师尧	画家
杨淑涛	人物
建溪	河流
刘昌潮	人物
亦农	人物
扬斯敦	城市
针灸大成	针灸
网格	术语
胡忠元	人物
杨佩珍	人物
中国石油天然气股份有限公司	石油
曾巩	文学家
iexplore	程序
石油	矿物
河智苑	明星
广彩	陶瓷
夏奇星	人物
狄	民族
许志英	人物
鄂尔多斯高原	高原
机油泵	齿轮泵
哥窑	陶瓷
嵇康	人物
灰漠土	土壤
柯有纶	明星
好美家	建材市场
武汉大学	武汉
蒋红岩	诗词
张静庐	人物
方文山	吴宗宪
怀尔德	人物
王西神	人物
顾大良	人物
海岩	人物
虹口乡	都江堰
何孔德	人物
张国琳	人物
徐畅	人物
科幻片	电影
李乃宙	人物
跳舞草	植物
求水山公园	山庄
殷培华	人物
姜增伟	商务部
白玉薇	人物
施易男	港台明星
针鼹	哺乳动物
西岛隆弘	明星
moschino	配饰
王西麟	人物
李味青	艺术家
易炎	人物
薏苡	中药材
常播	人物
黄金矿工	小游戏
新乐府	诗体
尹延新	人物
赵先闻	画家
amei	明星
侯孝贤	人物
方雪雯	人物
王世襄	学者
米家山	人物
单应桂	人物
丁牧	人物
京沈高速公路	交通枢纽
萨摩亚	岛国
清营汤	中药
胡经之	人物
吸浆虫	昆虫
igrp	网络通讯
电话机	家用电器
豚鼠	动物
钟腾福	运动员
蒲华	人物
万青力	人物
厢式车	专用汽车
季大纯	画家
张广才岭	山脉
王明居	人物
核酶	生物
陈明珠	人物
付双建	领导
木村拓哉	演员
蒙河	水系
瘦人乐队	歌手
平布	服装
李富勇	人物
张力尹	歌手
陶寿伯	画家
朴泰桓	体育明星
蒋夷牧	剧作家
田正平	人物
生态	生态系统
丁裕	人物
张学津	京剧
牛鹤亭	人物
重庆医科大学	医学院
肥城	城市
王荣山	老生
童世骏	人物
三氟乙酸乙酯	化学品
环流	定义
博城	城市
余本	画家
张春仲	人物
钾	化学元素
兰渐高	人物
京开高速公路	高速公路
罗非鱼	动物
仪征	扬州
李士群	汉奸
汞	有色金属
络石藤	药材
百草霜	中药材
姚龙顺	艺术家
涂松岩	影视明星
王竹溪	教授
梁彩霞	运动员
赵元礼	人物
科幻小说	科幻
彰化市	城市
后晋	五代十国
织锦	服装
沙鼠	野生动物
金维诺	人物
矿房	采矿
洪忠煌	作家
韦熊	人物
李美琪	人物
谭元寿	老生
巴色	城市
埙	音乐
年画	艺术品
卫辉	城市
陶长松	人物
干衣机	小家电
赵永伟	戏剧
孟遏云	人物
乌鲳	鱼类
倪瓒	山水画
记者证	资格考试
登陆舰	武器
朱颖人	艺术工作者
和路雪	品牌
恋恋	人物
萨斯尼茨	城市
郑若泉	人物
注册版	软件
武家祥	音乐
造形	工艺
牛筋草	禾本科
德珍	人物
谢东娜	美女
胡抗美	人物
秀姑峦溪	河流
拉脱维亚	也门
自动化	制造
李孟尧	人物
张辛稼	国画
赵本山	明星
展	人物
土壤资源	环境
孔紫	花鸟画
蓝豆娘	昆虫
中国证券业协会	证券公司
王丕震	作家
高塘湖	湖泊
池盐	盐业
保胎	胎儿
烙画	工艺品
张惠妹	明星
倪虹洁	歌手
重阳节	传统节日
澳门币	货币
贾世骏	艺人
amcap	软件
茨淮新河	河流
李青稞	人物
税源	税收
孙俪	人物
孙志群	明星
葛翠琳	作家
黄樟	树种
植村秀	彩妆
郑美珠	运动员
法属波利尼西亚	群岛
通量	定义
白僵蚕	中药
玛瑞格	舞蹈
洪秀贤	明星
成都双流国际机场	民航
马垣	人物
辽东半岛	半岛
刘文蓉	人物
毛霉	霉菌
徐元文	宰相
倪墨炎	作家
吴钧陶	作家
边秉贵	油画家
蝶呤	化学品
南召县	县
中国电力企业联合会	行业协会
鬼针草	菊科
唐大禧	人物
宁陕县	县
品牌价值	品牌
周伯桂	人物
双蕊兰	兰科
金彬雨	影视明星
帆船	体育项目
乔尔乔涅	人物
陶埙	民族乐器
杨树达	语言学家
副博士	学位
麻将机	家具
主观主义	客观主义
周忠陵	作家
经义考	著作
玉香桂	桂花
庄学本	摄影家
叶雨蒙	作家
扁桃体炎	五官科
黄进先	人物
李顺载	明星
何明翰	人物
亚纳河	河流
东野圭吾	侦探小说
文兴宇	人物
梁一贞	音乐
戴娆	明星
洪涝灾害	灾害
珠光体	金属加工
塞内加尔河	河流
破冰船	船
任爱翔	老师
朱里尼	音乐
新闻联播	中央电视台
不名一格	词语
火焰喷射器	枪械
卡瓦菲斯	人物
纹	瓷器
卢楞伽	画家
邓颖芝	明星
沈敏特	作家
拦沙坝	水利
康殷	书法家
吴谷祥	人物
张友松	作家
水玻璃	砂浆
徐贵樱	人物
冯玮君	人物
淤灌	水利
朱万章	画家
吕靖	人物
强度	制造
崇阳县	县区
柳琴	音乐
莱芜钢铁集团	公司
乐圣	人物
雍文华	作家
白玉素	花卉
米利	区划
陶大宇	港台明星
秦占宝	人物
韩乃寅	作家
罗炳芳	人物
蔡云娣	人物
宁都县	县区
卫星城	规划
潘玉书	人物
余少群	人物
钛酸钡	化学元素
罗苏民	人物
业务量	房产
民族自决权	国际法
拉丝模	模具
岳麓山	风景名胜
井上雄彦	漫画家
勒拿河	河流
上海浦东发展银行	上市公司
苏六娘	潮剧
朝华夕秀	词语
玫琳凯	时尚品牌
男低音	歌剧
南薰礁	地形
百草枯	农药
张海迪	人物
李砥平	领导人
盛巽昌	人物
薰香	香料
黄伦硕	艺人
埃拉泽	地区
中心法则	生物
郭锷权	人物
马争鸣	人物
周宝奎	人物
东北制药总厂	制药
林文洵	人物
吕利	作曲家
欧宝	汽车品牌
摩根斯坦利	公司
翁清海	人物
南清园	景点
姚士章	评话
陈书舫	川剧
眼虫	原生动物
孙云畴	江苏人
界面设计	设计
ㄤ	注音符号
兰晓龙	人物
茶梅	植物
胡歌	明星
释迦三尊	菩萨
陆国英	油画家
马蓝	爵床科
高黎贡山国家级自然保护区	自然保护区
朱士光	人物
李运熙	艺术家
行政区	区域
唱和	诗词
徐更生	人物
知母	中药
包楷	画家
罐车	车辆
孙大启	人物
狄志杰	艺人
朱杰勤	教育家
恶臭	污染
马语者	伦理片
林俊杰	明星
河莉秀	演员
指数	股票
人性美	美学
天课	穆斯林
中国地质大学	大学
罗石贤	作家
汤仙虎	教练员
苏必利尔	城市
卢守祥	领导
康有为	戊戌变法
刘佩琦	人物
叶丽仪	明星
海仙花	植物
汗牛充栋	词语
电子商务	网络营销
宜丰县	宜春
孟广美	人物
奥斯曼帝国	埃及
徐成淼	作家
梦醒	爱情
甘铁生	作家
王福庵	书法
詹姆斯湾	海湾
易小准	商务部
赛欧	轿车
巴松	管乐器
世界人权宣言	国际公约
跳远	田径
黄启成	人物
门帘	装饰
小龙人	电视剧
何训田	电影人
兰博基尼	汽车品牌
金属腐蚀	工程技术
袁文杰	明星
吊嗓	戏剧
琉球群岛	琉球
吕庆风	航空航天
钨	金属材料
约克角	岬角
书法	行书
董湘昆	人物
廖炯模	画家
罗小慈	人物
舒新城	人物
戴永斌	诗词
加濑亮	人物
毛主席纪念堂	纪念馆
水葱	莎草科
海鲋	鱼类
郭晓婷	人物
丹霞地貌	地形
绿色版	游戏
刘库仁	前秦
生肖	传统
育碧	公司
欧萃碧	化妆品
伍佰	歌手
姚广孝	和尚
周族	宗族
古生物学家	生物
上官清	人物
成昆铁路	铁路线
黄百鸣	港台明星
佩洛塔斯	地区
钢化玻璃	建材
田林县	地域
棠湖中学	学校
巴金	翻译家
赵博文	人物
infinity	游戏
营销	网络营销
统计力学	经典力学
海狗鞭	中成药
粉针剂	医药
于吉平	运动员
辛伐他汀	药品
铜精矿	矿物
襄垣县	县
郭世恩	人物
李小璐	歌手
taobao	淘宝网
海沟	海洋
世界大学生运动会	大学生
藏北高原	青藏高原
范小天	人物
小泽真珠	明星
棕熊	哺乳动物
万青力	画家
爱情观	恋爱
金灯	药材
玉涵堂	故居
不愧	词语
巧家县	昭通
芳香化湿	疗法
万隆会议	会议
画像石	考古
袁文杰	人物
顾麟士	名人
宇宙射线	宇宙
梅雪诗	表演艺术
田蕊妮	明星
宁明县	区划
田蕴章	著名作家
动笔	词语
北京友谊医院	医院
厉庄乡	行政区域
师范大学	大学
孔孚	名人
桂枝	药材
龚全安	明朝
鲁隐公	鲁国
新桥医院	医院
悉尼歌剧院	音乐厅
标准化	标准
穆旦	著名作家
兰博基尼	名车
网店	淘宝
红背桂	木本植物
劳红武	市长
